Possible decryption with key aam: Tduem kakj iswvfv wsfewsz yzmj kos fewjgg
Possible decryption with key aas: Tdoem kaej cswpfv wszewmz szmd kis zewdgg
Possible decryption with key aat: Tdnem kadj bswofv wsyewlz rzmc khs yewcgg
Possible decryption with key abm: Tcuel kzkj isvvfu wrfevsz yzlj jos fevjgf
Possible decryption with key abs: Tcoel kzej csvpfu wrzevmz szld jis zevdgf
Possible decryption with key abt: Tcnel kzdj bsvofu wryevlz rzlc jhs yevcgf
Possible decryption with key aci: Tbyek kyoj msuzft wqjeuwz czkn iss jeunge
Possible decryption with key acm: Tbuek kykj isuvft wqfeusz yzkj ios feujge
Possible decryption with key acn: Tbtek kyjj hsuuft wqeeurz xzki ins eeuige
Possible decryption with key acs: Tboek kyej csupft wqzeumz szkd iis zeudge
Possible decryption with key act: Tbnek kydj bsuoft wqyeulz rzkc ihs yeucge
Possible decryption with key adh: Tazej kxpj nstafs wpketxz dzjo hts ketogd
Possible decryption with key adm: Tauej kxkj istvfs wpfetsz yzjj hos fetjgd
Possible decryption with key adq: Taqej kxgj estrfs wpbetoz uzjf hks betfgd
Possible decryption with key ads: Taoej kxej cstpfs wpzetmz szjd his zetdgd
Possible decryption with key adt: Tanej kxdj bstofs wpyetlz rzjc hhs yetcgd
Possible decryption with key aed: Tzdei kwtj rssefr wooesbz hzis gxs oessgc
Possible decryption with key aei: Tzyei kwoj msszfr wojeswz czin gss jesngc
Possible decryption with key aem: Tzuei kwkj issvfr wofessz yzij gos fesjgc
Possible decryption with key aes: Tzoei kwej csspfr wozesmz szid gis zesdgc
Possible decryption with key aet: Tznei kwdj bssofr woyeslz rzic ghs yescgc
Possible decryption with key afm: Tyueh kvkj isrvfq wnfersz yzhj fos ferjgb
Possible decryption with key afs: Tyoeh kvej csrpfq wnzermz szhd fis zerdgb
Possible decryption with key aft: Tyneh kvdj bsrofq wnyerlz rzhc fhs yercgb
Possible decryption with key agm: Txueg kukj isqvfp wmfeqsz yzgj eos feqjga
Possible decryption with key ags: Txoeg kuej csqpfp wmzeqmz szgd eis zeqdga
Possible decryption with key agt: Txneg kudj bsqofp wmyeqlz rzgc ehs yeqcga
Possible decryption with key ahi: Twyef ktoj mspzfo wljepwz czfn dss jepngz
Possible decryption with key ahm: Twuef ktkj ispvfo wlfepsz yzfj dos fepjgz
Possible decryption with key ahs: Twoef ktej csppfo wlzepmz szfd dis zepdgz
Possible decryption with key aht: Twnef ktdj bspofo wlyeplz rzfc dhs yepcgz
Possible decryption with key aic: Tveee ksuj ssoffn wkpeocz izet cys peotgy
Possible decryption with key aim: Tvuee kskj isovfn wkfeosz yzej cos feojgy
Possible decryption with key aiq: Tvqee ksgj esorfn wkbeooz uzef cks beofgy
Possible decryption with key ais: Tvoee ksej csopfn wkzeomz szed cis zeodgy
Possible decryption with key ait: Tvnee ksdj bsoofn wkyeolz rzec chs yeocgy
Possible decryption with key aiz: Tvhee ksxj vsoifn wkseofz lzew cbs seowgy
Possible decryption with key ajm: Tuued krkj isnvfm wjfensz yzdj bos fenjgx
Possible decryption with key ajs: Tuoed krej csnpfm wjzenmz szdd bis zendgx
Possible decryption with key ajt: Tuned krdj bsnofm wjyenlz rzdc bhs yencgx
Possible decryption with key ake: Ttcec kqsj qsmdfl winemaz gzcr aws nemrgw
Possible decryption with key akm: Ttuec kqkj ismvfl wifemsz yzcj aos femjgw
Possible decryption with key aks: Ttoec kqej csmpfl wizemmz szcd ais zemdgw
Possible decryption with key akt: Ttnec kqdj bsmofl wiyemlz rzcc ahs yemcgw
Possible decryption with key akz: Tthec kqxj vsmifl wisemfz lzcw abs semwgw
Possible decryption with key alm: Tsueb kpkj islvfk whfelsz yzbj zos feljgv
Possible decryption with key als: Tsoeb kpej cslpfk whzelmz szbd zis zeldgv
Possible decryption with key alt: Tsneb kpdj bslofk whyellz rzbc zhs yelcgv
Possible decryption with key amm: Truea kokj iskvfj wgfeksz yzaj yos fekjgu
Possible decryption with key amr: Trpea kofj dskqfj wgaeknz tzae yjs aekegu
Possible decryption with key ams: Troea koej cskpfj wgzekmz szad yis zekdgu
Possible decryption with key amt: Trnea kodj bskofj wgyeklz rzac yhs yekcgu
Possible decryption with key anm: Tquez knkj isjvfi wffejsz yzzj xos fejjgt
Possible decryption with key ans: Tqoez knej csjpfi wfzejmz szzd xis zejdgt
Possible decryption with key ant: Tqnez kndj bsjofi wfyejlz rzzc xhs yejcgt
Possible decryption with key aod: Tpdey kmtj rsiefh weoeibz hzys wxs oeisgs
Possible decryption with key aoi: Tpyey kmoj msizfh wejeiwz czyn wss jeings
Possible decryption with key aom: Tpuey kmkj isivfh wefeisz yzyj wos feijgs
Possible decryption with key aop: Tprey kmhj fsisfh weceipz vzyg wls ceiggs
Possible decryption with key aor: Tppey kmfj dsiqfh weaeinz tzye wjs aeiegs
Possible decryption with key aos: Tpoey kmej csipfh wezeimz szyd wis zeidgs
Possible decryption with key aot: Tpney kmdj bsiofh weyeilz rzyc whs yeicgs
Possible decryption with key aou: Tpmey kmcj asinfh wexeikz qzyb wgs xeibgs
Possible decryption with key apa: Togex klwj ushhfg wdrehez kzxv vas rehvgr
Possible decryption with key apb: Tofex klvj tshgfg wdqehdz jzxu vzs qehugr
Possible decryption with key apc: Toeex kluj sshffg wdpehcz izxt vys pehtgr
Possible decryption with key apd: Todex kltj rshefg wdoehbz hzxs vxs oehsgr
Possible decryption with key ape: Tocex klsj qshdfg wdnehaz gzxr vws nehrgr
Possible decryption with key apf: Tobex klrj pshcfg wdmehzz fzxq vvs mehqgr
Possible decryption with key apg: Toaex klqj oshbfg wdlehyz ezxp vus lehpgr
Possible decryption with key aph: Tozex klpj nshafg wdkehxz dzxo vts kehogr
Possible decryption with key api: Toyex kloj mshzfg wdjehwz czxn vss jehngr
Possible decryption with key apj: Toxex klnj lshyfg wdiehvz bzxm vrs iehmgr
Possible decryption with key apk: Towex klmj kshxfg wdhehuz azxl vqs hehlgr
Possible decryption with key apl: Tovex kllj jshwfg wdgehtz zzxk vps gehkgr
Possible decryption with key apm: Touex klkj ishvfg wdfehsz yzxj vos fehjgr
Possible decryption with key apn: Totex kljj hshufg wdeehrz xzxi vns eehigr
Possible decryption with key apo: Tosex klij gshtfg wddehqz wzxh vms dehhgr
Possible decryption with key app: Torex klhj fshsfg wdcehpz vzxg vls cehggr
Possible decryption with key apq: Toqex klgj eshrfg wdbehoz uzxf vks behfgr
Possible decryption with key apr: Topex klfj dshqfg wdaehnz tzxe vjs aehegr
Possible decryption with key aps: Tooex klej cshpfg wdzehmz szxd vis zehdgr
Possible decryption with key apt: Tonex kldj bshofg wdyehlz rzxc vhs yehcgr
Possible decryption with key apu: Tomex klcj ashnfg wdxehkz qzxb vgs xehbgr
Possible decryption with key apv: Tolex klbj zshmfg wdwehjz pzxa vfs wehagr
Possible decryption with key apw: Tokex klaj yshlfg wdvehiz ozxz ves vehzgr
Possible decryption with key apx: Tojex klzj xshkfg wduehhz nzxy vds uehygr
Possible decryption with key apy: Toiex klyj wshjfg wdtehgz mzxx vcs tehxgr
Possible decryption with key apz: Tohex klxj vshifg wdsehfz lzxw vbs sehwgr
Possible decryption with key aqm: Tnuew kkkj isgvff wcfegsz yzwj uos fegjgq
Possible decryption with key aqs: Tnoew kkej csgpff wczegmz szwd uis zegdgq
Possible decryption with key aqt: Tnnew kkdj bsgoff wcyeglz rzwc uhs yegcgq
Possible decryption with key arm: Tmuev kjkj isfvfe wbfefsz yzvj tos fefjgp
Possible decryption with key ars: Tmoev kjej csfpfe wbzefmz szvd tis zefdgp
Possible decryption with key art: Tmnev kjdj bsfofe wbyeflz rzvc ths yefcgp
Possible decryption with key ase: Tlceu kisj qsedfd waneeaz gzur sws neergo
Possible decryption with key asj: Tlxeu kinj lseyfd waieevz bzum srs ieemgo
Possible decryption with key asm: Tlueu kikj isevfd wafeesz yzuj sos feejgo
Possible decryption with key ass: Tloeu kiej csepfd wazeemz szud sis zeedgo
Possible decryption with key ast: Tlneu kidj bseofd wayeelz rzuc shs yeecgo
Possible decryption with key ath: Tkzet khpj nsdafc wzkedxz dzto rts kedogn
Possible decryption with key atm: Tkuet khkj isdvfc wzfedsz yztj ros fedjgn
Possible decryption with key ats: Tkoet khej csdpfc wzzedmz sztd ris zeddgn
Possible decryption with key att: Tknet khdj bsdofc wzyedlz rztc rhs yedcgn
Possible decryption with key aum: Tjues kgkj iscvfb wyfecsz yzsj qos fecjgm
Possible decryption with key aus: Tjoes kgej cscpfb wyzecmz szsd qis zecdgm
Possible decryption with key aut: Tjnes kgdj bscofb wyyeclz rzsc qhs yeccgm
Possible decryption with key avm: Tiuer kfkj isbvfa wxfebsz yzrj pos febjgl
Possible decryption with key avo: Tiser kfij gsbtfa wxdebqz wzrh pms debhgl
Possible decryption with key avs: Tioer kfej csbpfa wxzebmz szrd pis zebdgl
Possible decryption with key avt: Tiner kfdj bsbofa wxyeblz rzrc phs yebcgl
Possible decryption with key awc: Theeq keuj ssaffz wwpeacz izqt oys peatgk
Possible decryption with key awm: Thueq kekj isavfz wwfeasz yzqj oos feajgk
Possible decryption with key aws: Thoeq keej csapfz wwzeamz szqd ois zeadgk
Possible decryption with key awt: Thneq kedj bsaofz wwyealz rzqc ohs yeacgk
Possible decryption with key awv: Thleq kebj zsamfz wwweajz pzqa ofs weaagk
Possible decryption with key axm: Tguep kdkj iszvfy wvfezsz yzpj nos fezjgj
Possible decryption with key axs: Tgoep kdej cszpfy wvzezmz szpd nis zezdgj
Possible decryption with key axt: Tgnep kddj bszofy wvyezlz rzpc nhs yezcgj
Possible decryption with key aym: Tfueo kckj isyvfx wufeysz yzoj mos feyjgi
Possible decryption with key ayq: Tfqeo kcgj esyrfx wubeyoz uzof mks beyfgi
Possible decryption with key ays: Tfoeo kcej csypfx wuzeymz szod mis zeydgi
Possible decryption with key ayt: Tfneo kcdj bsyofx wuyeylz rzoc mhs yeycgi
Possible decryption with key azd: Teden kbtj rsxefw wtoexbz hzns lxs oexsgh
Possible decryption with key azk: Tewen kbmj ksxxfw wthexuz aznl lqs hexlgh
Possible decryption with key azm: Teuen kbkj isxvfw wtfexsz yznj los fexjgh
Possible decryption with key azs: Teoen kbej csxpfw wtzexmz sznd lis zexdgh
Possible decryption with key azt: Tenen kbdj bsxofw wtyexlz rznc lhs yexcgh
Possible decryption with key bah: Sdzdm japi nrwaev vskdwxy dymo ktr kdwofg
Possible decryption with key bbh: Sczdl jzpi nrvaeu vrkdvxy dylo jtr kdvoff
Possible decryption with key bch: Sbzdk jypi nruaet vqkduxy dyko itr kduofe
Possible decryption with key bci: Sbydk jyoi mruzet vqjduwy cykn isr jdunfe
Possible decryption with key bcn: Sbtdk jyji hruuet vqedury xyki inr eduife
Possible decryption with key bda: Sagdj jxwi urthes vprdtey kyjv har rdtvfd
Possible decryption with key bdh: Sazdj jxpi nrtaes vpkdtxy dyjo htr kdtofd
Possible decryption with key bdq: Saqdj jxgi ertres vpbdtoy uyjf hkr bdtffd
Possible decryption with key bdt: Sandj jxdi brtoes vpydtly ryjc hhr ydtcfd
Possible decryption with key bed: Szddi jwti rrseer voodsby hyis gxr odssfc
Possible decryption with key beh: Szzdi jwpi nrsaer vokdsxy dyio gtr kdsofc
Possible decryption with key bei: Szydi jwoi mrszer vojdswy cyin gsr jdsnfc
Possible decryption with key bem: Szudi jwki irsver vofdssy yyij gor fdsjfc
Possible decryption with key bfh: Syzdh jvpi nrraeq vnkdrxy dyho ftr kdrofb
Possible decryption with key bgh: Sxzdg jupi nrqaep vmkdqxy dygo etr kdqofa
Possible decryption with key bhh: Swzdf jtpi nrpaeo vlkdpxy dyfo dtr kdpofz
Possible decryption with key bhi: Swydf jtoi mrpzeo vljdpwy cyfn dsr jdpnfz
Possible decryption with key bic: Svede jsui srofen vkpdocy iyet cyr pdotfy
Possible decryption with key bih: Svzde jspi nroaen vkkdoxy dyeo ctr kdoofy
Possible decryption with key biq: Svqde jsgi eroren vkbdooy uyef ckr bdoffy
Possible decryption with key biz: Svhde jsxi vroien vksdofy lyew cbr sdowfy
Possible decryption with key bjh: Suzdd jrpi nrnaem vjkdnxy dydo btr kdnofx
Possible decryption with key bke: Stcdc jqsi qrmdel vindmay gycr awr ndmrfw
Possible decryption with key bkh: Stzdc jqpi nrmael vikdmxy dyco atr kdmofw
Possible decryption with key bks: Stodc jqei crmpel vizdmmy sycd air zdmdfw
Possible decryption with key bkz: Sthdc jqxi vrmiel visdmfy lycw abr sdmwfw
Possible decryption with key blh: Sszdb jppi nrlaek vhkdlxy dybo ztr kdlofv
Possible decryption with key bmh: Srzda jopi nrkaej vgkdkxy dyao ytr kdkofu
Possible decryption with key bmr: Srpda jofi drkqej vgadkny tyae yjr adkefu
Possible decryption with key bnh: Sqzdz jnpi nrjaei vfkdjxy dyzo xtr kdjoft
Possible decryption with key bod: Spddy jmti rrieeh veodiby hyys wxr odisfs
Possible decryption with key boh: Spzdy jmpi nriaeh vekdixy dyyo wtr kdiofs
Possible decryption with key boi: Spydy jmoi mrizeh vejdiwy cyyn wsr jdinfs
Possible decryption with key bom: Spudy jmki iriveh vefdisy yyyj wor fdijfs
Possible decryption with key bop: Sprdy jmhi friseh vecdipy vyyg wlr cdigfs
Possible decryption with key bor: Sppdy jmfi driqeh veadiny tyye wjr adiefs
Possible decryption with key bou: Spmdy jmci arineh vexdiky qyyb wgr xdibfs
Possible decryption with key bpb: Sofdx jlvi trhgeg vdqdhdy jyxu vzr qdhufr
Possible decryption with key bph: Sozdx jlpi nrhaeg vdkdhxy dyxo vtr kdhofr
Possible decryption with key bqh: Snzdw jkpi nrgaef vckdgxy dywo utr kdgofq
Possible decryption with key brh: Smzdv jjpi nrfaee vbkdfxy dyvo ttr kdfofp
Possible decryption with key brm: Smudv jjki irfvee vbfdfsy yyvj tor fdfjfp
Possible decryption with key bse: Slcdu jisi qreded vandeay gyur swr nderfo
Possible decryption with key bsh: Slzdu jipi nreaed vakdexy dyuo str kdeofo
Possible decryption with key bsj: Slxdu jini lreyed vaidevy byum srr idemfo
Possible decryption with key bth: Skzdt jhpi nrdaec vzkddxy dyto rtr kddofn
Possible decryption with key buh: Sjzds jgpi nrcaeb vykdcxy dyso qtr kdcofm
Possible decryption with key bvh: Sizdr jfpi nrbaea vxkdbxy dyro ptr kdbofl
Possible decryption with key bvo: Sisdr jfii grbtea vxddbqy wyrh pmr ddbhfl
Possible decryption with key bvt: Sindr jfdi brboea vxydbly ryrc phr ydbcfl
Possible decryption with key bwh: Shzdq jepi nraaez vwkdaxy dyqo otr kdaofk
Possible decryption with key bwv: Shldq jebi zramez vwwdajy pyqa ofr wdaafk
Possible decryption with key bxh: Sgzdp jdpi nrzaey vvkdzxy dypo ntr kdzofj
Possible decryption with key byh: Sfzdo jcpi nryaex vukdyxy dyoo mtr kdyofi
Possible decryption with key byq: Sfqdo jcgi eryrex vubdyoy uyof mkr bdyffi
Possible decryption with key bzd: Seddn jbti rrxeew vtodxby hyns lxr odxsfh
Possible decryption with key bzh: Sezdn jbpi nrxaew vtkdxxy dyno ltr kdxofh
Possible decryption with key cci: Rbyck iyoh mquzdt uqjcuwx cxkn isq jcunee
Possible decryption with key ccn: Rbtck iyjh hquudt uqecurx xxki inq ecuiee
Possible decryption with key cdh: Razcj ixph nqtads upkctxx dxjo htq kctoed
Possible decryption with key cdo: Rascj ixih gqttds updctqx wxjh hmq dcthed
Possible decryption with key cdq: Raqcj ixgh eqtrds upbctox uxjf hkq bctfed
Possible decryption with key cdt: Rancj ixdh bqtods upyctlx rxjc hhq yctced
Possible decryption with key ced: Rzdci iwth rqsedr uoocsbx hxis gxq ocssec
Possible decryption with key cei: Rzyci iwoh mqszdr uojcswx cxin gsq jcsnec
Possible decryption with key cem: Rzuci iwkh iqsvdr uofcssx yxij goq fcsjec
Possible decryption with key chi: Rwycf itoh mqpzdo uljcpwx cxfn dsq jcpnez
Possible decryption with key cia: Rvgce iswh uqohdn ukrcoex kxev caq rcovey
Possible decryption with key cib: Rvfce isvh tqogdn ukqcodx jxeu czq qcouey
Possible decryption with key cic: Rvece isuh sqofdn ukpcocx ixet cyq pcotey
Possible decryption with key cid: Rvdce isth rqoedn ukocobx hxes cxq ocosey
Possible decryption with key cie: Rvcce issh qqoddn ukncoax gxer cwq ncorey
Possible decryption with key cif: Rvbce isrh pqocdn ukmcozx fxeq cvq mcoqey
Possible decryption with key cig: Rvace isqh oqobdn uklcoyx exep cuq lcopey
Possible decryption with key cih: Rvzce isph nqoadn ukkcoxx dxeo ctq kcooey
Possible decryption with key cii: Rvyce isoh mqozdn ukjcowx cxen csq jconey
Possible decryption with key cij: Rvxce isnh lqoydn ukicovx bxem crq icomey
Possible decryption with key cik: Rvwce ismh kqoxdn ukhcoux axel cqq hcoley
Possible decryption with key cil: Rvvce islh jqowdn ukgcotx zxek cpq gcokey
Possible decryption with key cim: Rvuce iskh iqovdn ukfcosx yxej coq fcojey
Possible decryption with key cin: Rvtce isjh hqoudn ukecorx xxei cnq ecoiey
Possible decryption with key cio: Rvsce isih gqotdn ukdcoqx wxeh cmq dcohey
Possible decryption with key cip: Rvrce ishh fqosdn ukccopx vxeg clq ccogey
Possible decryption with key ciq: Rvqce isgh eqordn ukbcoox uxef ckq bcofey
Possible decryption with key cir: Rvpce isfh dqoqdn ukaconx txee cjq acoeey
Possible decryption with key cis: Rvoce iseh cqopdn ukzcomx sxed ciq zcodey
Possible decryption with key cit: Rvnce isdh bqoodn ukycolx rxec chq ycocey
Possible decryption with key ciu: Rvmce isch aqondn ukxcokx qxeb cgq xcobey
Possible decryption with key civ: Rvlce isbh zqomdn ukwcojx pxea cfq wcoaey
Possible decryption with key ciw: Rvkce isah yqoldn ukvcoix oxez ceq vcozey
Possible decryption with key cix: Rvjce iszh xqokdn ukucohx nxey cdq ucoyey
Possible decryption with key ciy: Rvice isyh wqojdn uktcogx mxex ccq tcoxey
Possible decryption with key ciz: Rvhce isxh vqoidn ukscofx lxew cbq scowey
Possible decryption with key cke: Rtccc iqsh qqmddl uincmax gxcr awq ncmrew
Possible decryption with key cks: Rtocc iqeh cqmpdl uizcmmx sxcd aiq zcmdew
Possible decryption with key ckz: Rthcc iqxh vqmidl uiscmfx lxcw abq scmwew
Possible decryption with key cmr: Rrpca iofh dqkqdj ugacknx txae yjq ackeeu
Possible decryption with key cna: Rqgcz inwh uqjhdi ufrcjex kxzv xaq rcjvet
Possible decryption with key cnb: Rqfcz invh tqjgdi ufqcjdx jxzu xzq qcjuet
Possible decryption with key cnc: Rqecz inuh sqjfdi ufpcjcx ixzt xyq pcjtet
Possible decryption with key cnd: Rqdcz inth rqjedi ufocjbx hxzs xxq ocjset
Possible decryption with key cne: Rqccz insh qqjddi ufncjax gxzr xwq ncjret
Possible decryption with key cnf: Rqbcz inrh pqjcdi ufmcjzx fxzq xvq mcjqet
Possible decryption with key cng: Rqacz inqh oqjbdi uflcjyx exzp xuq lcjpet
Possible decryption with key cnh: Rqzcz inph nqjadi ufkcjxx dxzo xtq kcjoet
Possible decryption with key cni: Rqycz inoh mqjzdi ufjcjwx cxzn xsq jcjnet
Possible decryption with key cnj: Rqxcz innh lqjydi uficjvx bxzm xrq icjmet
Possible decryption with key cnk: Rqwcz inmh kqjxdi ufhcjux axzl xqq hcjlet
Possible decryption with key cnl: Rqvcz inlh jqjwdi ufgcjtx zxzk xpq gcjket
Possible decryption with key cnm: Rqucz inkh iqjvdi uffcjsx yxzj xoq fcjjet
Possible decryption with key cnn: Rqtcz injh hqjudi ufecjrx xxzi xnq ecjiet
Possible decryption with key cno: Rqscz inih gqjtdi ufdcjqx wxzh xmq dcjhet
Possible decryption with key cnp: Rqrcz inhh fqjsdi ufccjpx vxzg xlq ccjget
Possible decryption with key cnq: Rqqcz ingh eqjrdi ufbcjox uxzf xkq bcjfet
Possible decryption with key cnr: Rqpcz infh dqjqdi ufacjnx txze xjq acjeet
Possible decryption with key cns: Rqocz ineh cqjpdi ufzcjmx sxzd xiq zcjdet
Possible decryption with key cnt: Rqncz indh bqjodi ufycjlx rxzc xhq ycjcet
Possible decryption with key cnu: Rqmcz inch aqjndi ufxcjkx qxzb xgq xcjbet
Possible decryption with key cnv: Rqlcz inbh zqjmdi ufwcjjx pxza xfq wcjaet
Possible decryption with key cnw: Rqkcz inah yqjldi ufvcjix oxzz xeq vcjzet
Possible decryption with key cnx: Rqjcz inzh xqjkdi ufucjhx nxzy xdq ucjyet
Possible decryption with key cny: Rqicz inyh wqjjdi uftcjgx mxzx xcq tcjxet
Possible decryption with key cnz: Rqhcz inxh vqjidi ufscjfx lxzw xbq scjwet
Possible decryption with key cod: Rpdcy imth rqiedh ueocibx hxys wxq ocises
Possible decryption with key coi: Rpycy imoh mqizdh uejciwx cxyn wsq jcines
Possible decryption with key com: Rpucy imkh iqivdh uefcisx yxyj woq fcijes
Possible decryption with key cop: Rprcy imhh fqisdh ueccipx vxyg wlq cciges
Possible decryption with key cor: Rppcy imfh dqiqdh ueacinx txye wjq aciees
Possible decryption with key cou: Rpmcy imch aqindh uexcikx qxyb wgq xcibes
Possible decryption with key cpb: Rofcx ilvh tqhgdg udqchdx jxxu vzq qchuer
Possible decryption with key crm: Rmucv ijkh iqfvde ubfcfsx yxvj toq fcfjep
Possible decryption with key cse: Rlccu iish qqeddd uanceax gxur swq ncereo
Possible decryption with key csj: Rlxcu iinh lqeydd uaicevx bxum srq icemeo
Possible decryption with key cth: Rkzct ihph nqdadc uzkcdxx dxto rtq kcdoen
Possible decryption with key cvo: Riscr ifih gqbtda uxdcbqx wxrh pmq dcbhel
Possible decryption with key cvt: Rincr ifdh bqboda uxycblx rxrc phq ycbcel
Possible decryption with key cwu: Rhmcq iech aqandz uwxcakx qxqb ogq xcabek
Possible decryption with key cwv: Rhlcq iebh zqamdz uwwcajx pxqa ofq wcaaek
Possible decryption with key cyq: Rfqco icgh eqyrdx uubcyox uxof mkq bcyfei
Possible decryption with key czd: Redcn ibth rqxedw utocxbx hxns lxq ocxseh
Possible decryption with key dci: Qbybk hyog mpuzct tqjbuww cwkn isp jbunde
Possible decryption with key dcn: Qbtbk hyjg hpuuct tqeburw xwki inp ebuide
Possible decryption with key ddh: Qazbj hxpg nptacs tpkbtxw dwjo htp kbtodd
Possible decryption with key ddq: Qaqbj hxgg eptrcs tpbbtow uwjf hkp bbtfdd
Possible decryption with key ddt: Qanbj hxdg bptocs tpybtlw rwjc hhp ybtcdd
Possible decryption with key dea: Qzgbi hwwg upshcr torbsew kwiv gap rbsvdc
Possible decryption with key deb: Qzfbi hwvg tpsgcr toqbsdw jwiu gzp qbsudc
Possible decryption with key dec: Qzebi hwug spsfcr topbscw iwit gyp pbstdc
Possible decryption with key ded: Qzdbi hwtg rpsecr toobsbw hwis gxp obssdc
Possible decryption with key dee: Qzcbi hwsg qpsdcr tonbsaw gwir gwp nbsrdc
Possible decryption with key def: Qzbbi hwrg ppsccr tombszw fwiq gvp mbsqdc
Possible decryption with key deg: Qzabi hwqg opsbcr tolbsyw ewip gup lbspdc
Possible decryption with key deh: Qzzbi hwpg npsacr tokbsxw dwio gtp kbsodc
Possible decryption with key dei: Qzybi hwog mpszcr tojbsww cwin gsp jbsndc
Possible decryption with key dej: Qzxbi hwng lpsycr toibsvw bwim grp ibsmdc
Possible decryption with key dek: Qzwbi hwmg kpsxcr tohbsuw awil gqp hbsldc
Possible decryption with key del: Qzvbi hwlg jpswcr togbstw zwik gpp gbskdc
Possible decryption with key dem: Qzubi hwkg ipsvcr tofbssw ywij gop fbsjdc
Possible decryption with key den: Qztbi hwjg hpsucr toebsrw xwii gnp ebsidc
Possible decryption with key deo: Qzsbi hwig gpstcr todbsqw wwih gmp dbshdc
Possible decryption with key dep: Qzrbi hwhg fpsscr tocbspw vwig glp cbsgdc
Possible decryption with key deq: Qzqbi hwgg epsrcr tobbsow uwif gkp bbsfdc
Possible decryption with key der: Qzpbi hwfg dpsqcr toabsnw twie gjp absedc
Possible decryption with key des: Qzobi hweg cpspcr tozbsmw swid gip zbsddc
Possible decryption with key det: Qznbi hwdg bpsocr toybslw rwic ghp ybscdc
Possible decryption with key deu: Qzmbi hwcg apsncr toxbskw qwib ggp xbsbdc
Possible decryption with key dev: Qzlbi hwbg zpsmcr towbsjw pwia gfp wbsadc
Possible decryption with key dew: Qzkbi hwag ypslcr tovbsiw owiz gep vbszdc
Possible decryption with key dex: Qzjbi hwzg xpskcr toubshw nwiy gdp ubsydc
Possible decryption with key dey: Qzibi hwyg wpsjcr totbsgw mwix gcp tbsxdc
Possible decryption with key dez: Qzhbi hwxg vpsicr tosbsfw lwiw gbp sbswdc
Possible decryption with key dhi: Qwybf htog mppzco tljbpww cwfn dsp jbpndz
Possible decryption with key dic: Qvebe hsug spofcn tkpbocw iwet cyp pbotdy
Possible decryption with key diq: Qvqbe hsgg eporcn tkbboow uwef ckp bbofdy
Possible decryption with key diz: Qvhbe hsxg vpoicn tksbofw lwew cbp sbowdy
Possible decryption with key dke: Qtcbc hqsg qpmdcl tinbmaw gwcr awp nbmrdw
Possible decryption with key dks: Qtobc hqeg cpmpcl tizbmmw swcd aip zbmddw
Possible decryption with key dkz: Qthbc hqxg vpmicl tisbmfw lwcw abp sbmwdw
Possible decryption with key dln: Qstbb hpjg hpluck theblrw xwbi znp eblidv
Possible decryption with key dmr: Qrpba hofg dpkqcj tgabknw twae yjp abkedu
Possible decryption with key dod: Qpdby hmtg rpiech teobibw hwys wxp obisds
Possible decryption with key doi: Qpyby hmog mpizch tejbiww cwyn wsp jbinds
Possible decryption with key dom: Qpuby hmkg ipivch tefbisw ywyj wop fbijds
Possible decryption with key dop: Qprby hmhg fpisch tecbipw vwyg wlp cbigds
Possible decryption with key dor: Qppby hmfg dpiqch teabinw twye wjp abieds
Possible decryption with key dou: Qpmby hmcg apinch texbikw qwyb wgp xbibds
Possible decryption with key dpb: Qofbx hlvg tphgcg tdqbhdw jwxu vzp qbhudr
Possible decryption with key drm: Qmubv hjkg ipfvce tbfbfsw ywvj top fbfjdp
Possible decryption with key dse: Qlcbu hisg qpedcd tanbeaw gwur swp nberdo
Possible decryption with key dsj: Qlxbu hing lpeycd taibevw bwum srp ibemdo
Possible decryption with key dth: Qkzbt hhpg npdacc tzkbdxw dwto rtp kbdodn
Possible decryption with key dvo: Qisbr hfig gpbtca txdbbqw wwrh pmp dbbhdl
Possible decryption with key dvt: Qinbr hfdg bpboca txybblw rwrc php ybbcdl
Possible decryption with key dwi: Qhybq heog mpazcz twjbaww cwqn osp jbandk
Possible decryption with key dwv: Qhlbq hebg zpamcz twwbajw pwqa ofp wbaadk
Possible decryption with key dyq: Qfqbo hcgg epyrcx tubbyow uwof mkp bbyfdi
Possible decryption with key dzd: Qedbn hbtg rpxecw ttobxbw hwns lxp obxsdh
Possible decryption with key eab: Pdfam gavf towgbv ssqawdv jvmu kzo qawucg
Possible decryption with key eah: Pdzam gapf nowabv sskawxv dvmo kto kawocg
Possible decryption with key eai: Pdyam gaof mowzbv ssjawwv cvmn kso jawncg
Possible decryption with key ebb: Pcfal gzvf tovgbu srqavdv jvlu jzo qavucf
Possible decryption with key ebh: Pczal gzpf novabu srkavxv dvlo jto kavocf
Possible decryption with key ebi: Pcyal gzof movzbu srjavwv cvln jso javncf
Possible decryption with key ecb: Pbfak gyvf tougbt sqqaudv jvku izo qauuce
Possible decryption with key ech: Pbzak gypf nouabt sqkauxv dvko ito kauoce
Possible decryption with key eci: Pbyak gyof mouzbt sqjauwv cvkn iso jaunce
Possible decryption with key ecn: Pbtak gyjf houubt sqeaurv xvki ino eauice
Possible decryption with key edb: Pafaj gxvf totgbs spqatdv jvju hzo qatucd
Possible decryption with key edh: Pazaj gxpf notabs spkatxv dvjo hto katocd
Possible decryption with key edi: Payaj gxof motzbs spjatwv cvjn hso jatncd
Possible decryption with key edq: Paqaj gxgf eotrbs spbatov uvjf hko batfcd
Possible decryption with key edt: Panaj gxdf botobs spyatlv rvjc hho yatccd
Possible decryption with key eeb: Pzfai gwvf tosgbr soqasdv jviu gzo qasucc
Possible decryption with key eed: Pzdai gwtf rosebr sooasbv hvis gxo oasscc
Possible decryption with key eeh: Pzzai gwpf nosabr sokasxv dvio gto kasocc
Possible decryption with key eei: Pzyai gwof moszbr sojaswv cvin gso jasncc
Possible decryption with key eem: Pzuai gwkf iosvbr sofassv yvij goo fasjcc
Possible decryption with key efb: Pyfah gvvf torgbq snqardv jvhu fzo qarucb
Possible decryption with key efh: Pyzah gvpf norabq snkarxv dvho fto karocb
Possible decryption with key efi: Pyyah gvof morzbq snjarwv cvhn fso jarncb
Possible decryption with key egb: Pxfag guvf toqgbp smqaqdv jvgu ezo qaquca
Possible decryption with key egh: Pxzag gupf noqabp smkaqxv dvgo eto kaqoca
Possible decryption with key egi: Pxyag guof moqzbp smjaqwv cvgn eso jaqnca
Possible decryption with key ehb: Pwfaf gtvf topgbo slqapdv jvfu dzo qapucz
Possible decryption with key ehh: Pwzaf gtpf nopabo slkapxv dvfo dto kapocz
Possible decryption with key ehi: Pwyaf gtof mopzbo sljapwv cvfn dso japncz
Possible decryption with key eib: Pvfae gsvf toogbn skqaodv jveu czo qaoucy
Possible decryption with key eic: Pveae gsuf soofbn skpaocv ivet cyo paotcy
Possible decryption with key eih: Pvzae gspf nooabn skkaoxv dveo cto kaoocy
Possible decryption with key eii: Pvyae gsof moozbn skjaowv cven cso jaoncy
Possible decryption with key eiq: Pvqae gsgf eoorbn skbaoov uvef cko baofcy
Possible decryption with key eiz: Pvhae gsxf vooibn sksaofv lvew cbo saowcy
Possible decryption with key ejb: Pufad grvf tongbm sjqandv jvdu bzo qanucx
Possible decryption with key ejh: Puzad grpf nonabm sjkanxv dvdo bto kanocx
Possible decryption with key eji: Puyad grof monzbm sjjanwv cvdn bso janncx
Possible decryption with key ejs: Puoad gref conpbm sjzanmv svdd bio zandcx
Possible decryption with key ekb: Ptfac gqvf tomgbl siqamdv jvcu azo qamucw
Possible decryption with key eke: Ptcac gqsf qomdbl sinamav gvcr awo namrcw
Possible decryption with key ekh: Ptzac gqpf nomabl sikamxv dvco ato kamocw
Possible decryption with key eki: Ptyac gqof momzbl sijamwv cvcn aso jamncw
Possible decryption with key eks: Ptoac gqef compbl sizammv svcd aio zamdcw
Possible decryption with key ekz: Pthac gqxf vomibl sisamfv lvcw abo samwcw
Possible decryption with key elb: Psfab gpvf tolgbk shqaldv jvbu zzo qalucv
Possible decryption with key elh: Pszab gppf nolabk shkalxv dvbo zto kalocv
Possible decryption with key eli: Psyab gpof molzbk shjalwv cvbn zso jalncv
Possible decryption with key emb: Prfaa govf tokgbj sgqakdv jvau yzo qakucu
Possible decryption with key emh: Przaa gopf nokabj sgkakxv dvao yto kakocu
Possible decryption with key emi: Pryaa goof mokzbj sgjakwv cvan yso jakncu
Possible decryption with key emr: Prpaa goff dokqbj sgaaknv tvae yjo aakecu
Possible decryption with key enb: Pqfaz gnvf tojgbi sfqajdv jvzu xzo qajuct
Possible decryption with key enh: Pqzaz gnpf nojabi sfkajxv dvzo xto kajoct
Possible decryption with key eni: Pqyaz gnof mojzbi sfjajwv cvzn xso jajnct
Possible decryption with key eob: Ppfay gmvf toigbh seqaidv jvyu wzo qaiucs
Possible decryption with key eod: Ppday gmtf roiebh seoaibv hvys wxo oaiscs
Possible decryption with key eoh: Ppzay gmpf noiabh sekaixv dvyo wto kaiocs
Possible decryption with key eoi: Ppyay gmof moizbh sejaiwv cvyn wso jaincs
Possible decryption with key eom: Ppuay gmkf ioivbh sefaisv yvyj woo faijcs
Possible decryption with key eop: Ppray gmhf foisbh secaipv vvyg wlo caigcs
Possible decryption with key eor: Pppay gmff doiqbh seaainv tvye wjo aaiecs
Possible decryption with key eou: Ppmay gmcf aoinbh sexaikv qvyb wgo xaibcs
Possible decryption with key epb: Pofax glvf tohgbg sdqahdv jvxu vzo qahucr
Possible decryption with key eph: Pozax glpf nohabg sdkahxv dvxo vto kahocr
Possible decryption with key epi: Poyax glof mohzbg sdjahwv cvxn vso jahncr
Possible decryption with key eqb: Pnfaw gkvf toggbf scqagdv jvwu uzo qagucq
Possible decryption with key eqh: Pnzaw gkpf nogabf sckagxv dvwo uto kagocq
Possible decryption with key eqi: Pnyaw gkof mogzbf scjagwv cvwn uso jagncq
Possible decryption with key era: Pmgav gjwf uofhbe sbrafev kvvv tao rafvcp
Possible decryption with key erb: Pmfav gjvf tofgbe sbqafdv jvvu tzo qafucp
Possible decryption with key erc: Pmeav gjuf soffbe sbpafcv ivvt tyo paftcp
Possible decryption with key erd: Pmdav gjtf rofebe sboafbv hvvs txo oafscp
Possible decryption with key ere: Pmcav gjsf qofdbe sbnafav gvvr two nafrcp
Possible decryption with key erf: Pmbav gjrf pofcbe sbmafzv fvvq tvo mafqcp
Possible decryption with key erg: Pmaav gjqf oofbbe sblafyv evvp tuo lafpcp
Possible decryption with key erh: Pmzav gjpf nofabe sbkafxv dvvo tto kafocp
Possible decryption with key eri: Pmyav gjof mofzbe sbjafwv cvvn tso jafncp
Possible decryption with key erj: Pmxav gjnf lofybe sbiafvv bvvm tro iafmcp
Possible decryption with key erk: Pmwav gjmf kofxbe sbhafuv avvl tqo haflcp
Possible decryption with key erl: Pmvav gjlf jofwbe sbgaftv zvvk tpo gafkcp
Possible decryption with key erm: Pmuav gjkf iofvbe sbfafsv yvvj too fafjcp
Possible decryption with key ern: Pmtav gjjf hofube sbeafrv xvvi tno eaficp
Possible decryption with key ero: Pmsav gjif goftbe sbdafqv wvvh tmo dafhcp
Possible decryption with key erp: Pmrav gjhf fofsbe sbcafpv vvvg tlo cafgcp
Possible decryption with key erq: Pmqav gjgf eofrbe sbbafov uvvf tko baffcp
Possible decryption with key err: Pmpav gjff dofqbe sbaafnv tvve tjo aafecp
Possible decryption with key ers: Pmoav gjef cofpbe sbzafmv svvd tio zafdcp
Possible decryption with key ert: Pmnav gjdf bofobe sbyaflv rvvc tho yafccp
Possible decryption with key eru: Pmmav gjcf aofnbe sbxafkv qvvb tgo xafbcp
Possible decryption with key erv: Pmlav gjbf zofmbe sbwafjv pvva tfo wafacp
Possible decryption with key erw: Pmkav gjaf yoflbe sbvafiv ovvz teo vafzcp
Possible decryption with key erx: Pmjav gjzf xofkbe sbuafhv nvvy tdo uafycp
Possible decryption with key ery: Pmiav gjyf wofjbe sbtafgv mvvx tco tafxcp
Possible decryption with key erz: Pmhav gjxf vofibe sbsaffv lvvw tbo safwcp
Possible decryption with key esb: Plfau givf toegbd saqaedv jvuu szo qaeuco
Possible decryption with key ese: Plcau gisf qoedbd sanaeav gvur swo naerco
Possible decryption with key esh: Plzau gipf noeabd sakaexv dvuo sto kaeoco
Possible decryption with key esi: Plyau giof moezbd sajaewv cvun sso jaenco
Possible decryption with key esj: Plxau ginf loeybd saiaevv bvum sro iaemco
Possible decryption with key etb: Pkfat ghvf todgbc szqaddv jvtu rzo qaducn
Possible decryption with key eth: Pkzat ghpf nodabc szkadxv dvto rto kadocn
Possible decryption with key eti: Pkyat ghof modzbc szjadwv cvtn rso jadncn
Possible decryption with key eub: Pjfas ggvf tocgbb syqacdv jvsu qzo qacucm
Possible decryption with key euh: Pjzas ggpf nocabb sykacxv dvso qto kacocm
Possible decryption with key eui: Pjyas ggof moczbb syjacwv cvsn qso jacncm
Possible decryption with key evb: Pifar gfvf tobgba sxqabdv jvru pzo qabucl
Possible decryption with key evh: Pizar gfpf nobaba sxkabxv dvro pto kabocl
Possible decryption with key evi: Piyar gfof mobzba sxjabwv cvrn pso jabncl
Possible decryption with key evo: Pisar gfif gobtba sxdabqv wvrh pmo dabhcl
Possible decryption with key evt: Pinar gfdf boboba sxyablv rvrc pho yabccl
Possible decryption with key ewb: Phfaq gevf toagbz swqaadv jvqu ozo qaauck
Possible decryption with key ewh: Phzaq gepf noaabz swkaaxv dvqo oto kaaock
Possible decryption with key ewi: Phyaq geof moazbz swjaawv cvqn oso jaanck
Possible decryption with key ewv: Phlaq gebf zoambz swwaajv pvqa ofo waaack
Possible decryption with key exb: Pgfap gdvf tozgby svqazdv jvpu nzo qazucj
Possible decryption with key exh: Pgzap gdpf nozaby svkazxv dvpo nto kazocj
Possible decryption with key exi: Pgyap gdof mozzby svjazwv cvpn nso jazncj
Possible decryption with key eyb: Pffao gcvf toygbx suqaydv jvou mzo qayuci
Possible decryption with key eyh: Pfzao gcpf noyabx sukayxv dvoo mto kayoci
Possible decryption with key eyi: Pfyao gcof moyzbx sujaywv cvon mso jaynci
Possible decryption with key eyq: Pfqao gcgf eoyrbx subayov uvof mko bayfci
Possible decryption with key ezb: Pefan gbvf toxgbw stqaxdv jvnu lzo qaxuch
Possible decryption with key ezd: Pedan gbtf roxebw stoaxbv hvns lxo oaxsch
Possible decryption with key ezh: Pezan gbpf noxabw stkaxxv dvno lto kaxoch
Possible decryption with key ezi: Peyan gbof moxzbw stjaxwv cvnn lso jaxnch
Possible decryption with key fam: Oduzm fake inwvav rsfzwsu yumj kon fzwjbg
Possible decryption with key fas: Odozm faee cnwpav rszzwmu sumd kin zzwdbg
Possible decryption with key fbm: Ocuzl fzke invvau rrfzvsu yulj jon fzvjbf
Possible decryption with key fbs: Ocozl fzee cnvpau rrzzvmu suld jin zzvdbf
Possible decryption with key fci: Obyzk fyoe mnuzat rqjzuwu cukn isn jzunbe
Possible decryption with key fcm: Obuzk fyke inuvat rqfzusu yukj ion fzujbe
Possible decryption with key fcn: Obtzk fyje hnuuat rqezuru xuki inn ezuibe
Possible decryption with key fcs: Obozk fyee cnupat rqzzumu sukd iin zzudbe
Possible decryption with key fdh: Oazzj fxpe nntaas rpkztxu dujo htn kztobd
Possible decryption with key fdm: Oauzj fxke intvas rpfztsu yujj hon fztjbd
Possible decryption with key fdq: Oaqzj fxge entras rpbztou uujf hkn bztfbd
Possible decryption with key fds: Oaozj fxee cntpas rpzztmu sujd hin zztdbd
Possible decryption with key fdt: Oanzj fxde bntoas rpyztlu rujc hhn yztcbd
Possible decryption with key fed: Ozdzi fwte rnsear roozsbu huis gxn ozssbc
Possible decryption with key fei: Ozyzi fwoe mnszar rojzswu cuin gsn jzsnbc
Possible decryption with key fem: Ozuzi fwke insvar rofzssu yuij gon fzsjbc
Possible decryption with key fes: Ozozi fwee cnspar rozzsmu suid gin zzsdbc
Possible decryption with key ffm: Oyuzh fvke inrvaq rnfzrsu yuhj fon fzrjbb
Possible decryption with key ffs: Oyozh fvee cnrpaq rnzzrmu suhd fin zzrdbb
Possible decryption with key fgm: Oxuzg fuke inqvap rmfzqsu yugj eon fzqjba
Possible decryption with key fgs: Oxozg fuee cnqpap rmzzqmu sugd ein zzqdba
Possible decryption with key fhi: Owyzf ftoe mnpzao rljzpwu cufn dsn jzpnbz
Possible decryption with key fhm: Owuzf ftke inpvao rlfzpsu yufj don fzpjbz
Possible decryption with key fhp: Owrzf fthe fnpsao rlczppu vufg dln czpgbz
Possible decryption with key fhs: Owozf ftee cnppao rlzzpmu sufd din zzpdbz
Possible decryption with key fic: Oveze fsue snofan rkpzocu iuet cyn pzotby
Possible decryption with key fim: Ovuze fske inovan rkfzosu yuej con fzojby
Possible decryption with key fiq: Ovqze fsge enoran rkbzoou uuef ckn bzofby
Possible decryption with key fis: Ovoze fsee cnopan rkzzomu sued cin zzodby
Possible decryption with key fiz: Ovhze fsxe vnoian rkszofu luew cbn szowby
Possible decryption with key fjm: Ouuzd frke innvam rjfznsu yudj bon fznjbx
Possible decryption with key fjs: Ouozd free cnnpam rjzznmu sudd bin zzndbx
Possible decryption with key fke: Otczc fqse qnmdal rinzmau gucr awn nzmrbw
Possible decryption with key fkm: Otuzc fqke inmval rifzmsu yucj aon fzmjbw
Possible decryption with key fks: Otozc fqee cnmpal rizzmmu sucd ain zzmdbw
Possible decryption with key fkz: Othzc fqxe vnmial riszmfu lucw abn szmwbw
Possible decryption with key flm: Osuzb fpke inlvak rhfzlsu yubj zon fzljbv
Possible decryption with key fls: Osozb fpee cnlpak rhzzlmu subd zin zzldbv
Possible decryption with key fmm: Oruza foke inkvaj rgfzksu yuaj yon fzkjbu
Possible decryption with key fmr: Orpza fofe dnkqaj rgazknu tuae yjn azkebu
Possible decryption with key fms: Oroza foee cnkpaj rgzzkmu suad yin zzkdbu
Possible decryption with key fnm: Oquzz fnke injvai rffzjsu yuzj xon fzjjbt
Possible decryption with key fns: Oqozz fnee cnjpai rfzzjmu suzd xin zzjdbt
Possible decryption with key fod: Opdzy fmte rnieah reozibu huys wxn ozisbs
Possible decryption with key foi: Opyzy fmoe mnizah rejziwu cuyn wsn jzinbs
Possible decryption with key fom: Opuzy fmke inivah refzisu yuyj won fzijbs
Possible decryption with key fop: Oprzy fmhe fnisah reczipu vuyg wln czigbs
Possible decryption with key for: Oppzy fmfe dniqah reazinu tuye wjn aziebs
Possible decryption with key fos: Opozy fmee cnipah rezzimu suyd win zzidbs
Possible decryption with key fou: Opmzy fmce aninah rexziku quyb wgn xzibbs
Possible decryption with key fpb: Oofzx flve tnhgag rdqzhdu juxu vzn qzhubr
Possible decryption with key fpm: Oouzx flke inhvag rdfzhsu yuxj von fzhjbr
Possible decryption with key fps: Ooozx flee cnhpag rdzzhmu suxd vin zzhdbr
Possible decryption with key fqm: Onuzw fkke ingvaf rcfzgsu yuwj uon fzgjbq
Possible decryption with key fqs: Onozw fkee cngpaf rczzgmu suwd uin zzgdbq
Possible decryption with key frm: Omuzv fjke infvae rbfzfsu yuvj ton fzfjbp
Possible decryption with key frs: Omozv fjee cnfpae rbzzfmu suvd tin zzfdbp
Possible decryption with key fse: Olczu fise qnedad ranzeau guur swn nzerbo
Possible decryption with key fsj: Olxzu fine lneyad raizevu buum srn izembo
Possible decryption with key fsm: Oluzu fike inevad rafzesu yuuj son fzejbo
Possible decryption with key fss: Olozu fiee cnepad razzemu suud sin zzedbo
Possible decryption with key fth: Okzzt fhpe nndaac rzkzdxu duto rtn kzdobn
Possible decryption with key ftm: Okuzt fhke indvac rzfzdsu yutj ron fzdjbn
Possible decryption with key fts: Okozt fhee cndpac rzzzdmu sutd rin zzddbn
Possible decryption with key ftu: Okmzt fhce andnac rzxzdku qutb rgn xzdbbn
Possible decryption with key fum: Ojuzs fgke incvab ryfzcsu yusj qon fzcjbm
Possible decryption with key fus: Ojozs fgee cncpab ryzzcmu susd qin zzcdbm
Possible decryption with key fvm: Oiuzr ffke inbvaa rxfzbsu yurj pon fzbjbl
Possible decryption with key fvo: Oiszr ffie gnbtaa rxdzbqu wurh pmn dzbhbl
Possible decryption with key fvs: Oiozr ffee cnbpaa rxzzbmu surd pin zzbdbl
Possible decryption with key fvt: Oinzr ffde bnboaa rxyzblu rurc phn yzbcbl
Possible decryption with key fwm: Ohuzq feke inavaz rwfzasu yuqj oon fzajbk
Possible decryption with key fws: Ohozq feee cnapaz rwzzamu suqd oin zzadbk
Possible decryption with key fwv: Ohlzq febe znamaz rwwzaju puqa ofn wzaabk
Possible decryption with key fxm: Oguzp fdke inzvay rvfzzsu yupj non fzzjbj
Possible decryption with key fxs: Ogozp fdee cnzpay rvzzzmu supd nin zzzdbj
Possible decryption with key fya: Ofgzo fcwe unyhax rurzyeu kuov man rzyvbi
Possible decryption with key fyb: Offzo fcve tnygax ruqzydu juou mzn qzyubi
Possible decryption with key fyc: Ofezo fcue snyfax rupzycu iuot myn pzytbi
Possible decryption with key fyd: Ofdzo fcte rnyeax ruozybu huos mxn ozysbi
Possible decryption with key fye: Ofczo fcse qnydax runzyau guor mwn nzyrbi
Possible decryption with key fyf: Ofbzo fcre pnycax rumzyzu fuoq mvn mzyqbi
Possible decryption with key fyg: Ofazo fcqe onybax rulzyyu euop mun lzypbi
Possible decryption with key fyh: Ofzzo fcpe nnyaax rukzyxu duoo mtn kzyobi
Possible decryption with key fyi: Ofyzo fcoe mnyzax rujzywu cuon msn jzynbi
Possible decryption with key fyj: Ofxzo fcne lnyyax ruizyvu buom mrn izymbi
Possible decryption with key fyk: Ofwzo fcme knyxax ruhzyuu auol mqn hzylbi
Possible decryption with key fyl: Ofvzo fcle jnywax rugzytu zuok mpn gzykbi
Possible decryption with key fym: Ofuzo fcke inyvax rufzysu yuoj mon fzyjbi
Possible decryption with key fyn: Oftzo fcje hnyuax ruezyru xuoi mnn ezyibi
Possible decryption with key fyo: Ofszo fcie gnytax rudzyqu wuoh mmn dzyhbi
Possible decryption with key fyp: Ofrzo fche fnysax ruczypu vuog mln czygbi
Possible decryption with key fyq: Ofqzo fcge enyrax rubzyou uuof mkn bzyfbi
Possible decryption with key fyr: Ofpzo fcfe dnyqax ruazynu tuoe mjn azyebi
Possible decryption with key fys: Ofozo fcee cnypax ruzzymu suod min zzydbi
Possible decryption with key fyt: Ofnzo fcde bnyoax ruyzylu ruoc mhn yzycbi
Possible decryption with key fyu: Ofmzo fcce anynax ruxzyku quob mgn xzybbi
Possible decryption with key fyv: Oflzo fcbe znymax ruwzyju puoa mfn wzyabi
Possible decryption with key fyw: Ofkzo fcae ynylax ruvzyiu ouoz men vzyzbi
Possible decryption with key fyx: Ofjzo fcze xnykax ruuzyhu nuoy mdn uzyybi
Possible decryption with key fyy: Ofizo fcye wnyjax rutzygu muox mcn tzyxbi
Possible decryption with key fyz: Ofhzo fcxe vnyiax ruszyfu luow mbn szywbi
Possible decryption with key fzd: Oedzn fbte rnxeaw rtozxbu huns lxn ozxsbh
Possible decryption with key fzm: Oeuzn fbke inxvaw rtfzxsu yunj lon fzxjbh
Possible decryption with key fzs: Oeozn fbee cnxpaw rtzzxmu sund lin zzxdbh
Possible decryption with key gaj: Ndxym eand lmwyzv qsiywvt btmm krm iywmag
Possible decryption with key gci: Nbyyk eyod mmuzzt qqjyuwt ctkn ism jyunae
Possible decryption with key gcn: Nbtyk eyjd hmuuzt qqeyurt xtki inm eyuiae
Possible decryption with key gdh: Nazyj expd nmtazs qpkytxt dtjo htm kytoad
Possible decryption with key gdq: Naqyj exgd emtrzs qpbytot utjf hkm bytfad
Possible decryption with key gdt: Nanyj exdd bmtozs qpyytlt rtjc hhm yytcad
Possible decryption with key ged: Nzdyi ewtd rmsezr qooysbt htis gxm oyssac
Possible decryption with key gei: Nzyyi ewod mmszzr qojyswt ctin gsm jysnac
Possible decryption with key gem: Nzuyi ewkd imsvzr qofysst ytij gom fysjac
Possible decryption with key gfr: Nypyh evfd dmrqzq qnayrnt tthe fjm ayreab
Possible decryption with key ghi: Nwyyf etod mmpzzo qljypwt ctfn dsm jypnaz
Possible decryption with key gic: Nveye esud smofzn qkpyoct itet cym pyotay
Possible decryption with key giq: Nvqye esgd emorzn qkbyoot utef ckm byofay
Possible decryption with key giz: Nvhye esxd vmoizn qksyoft ltew cbm syoway
Possible decryption with key gke: Ntcyc eqsd qmmdzl qinymat gtcr awm nymraw
Possible decryption with key gks: Ntoyc eqed cmmpzl qizymmt stcd aim zymdaw
Possible decryption with key gkz: Nthyc eqxd vmmizl qisymft ltcw abm symwaw
Possible decryption with key gmr: Nrpya eofd dmkqzj qgayknt ttae yjm aykeau
Possible decryption with key god: Npdyy emtd rmiezh qeoyibt htys wxm oyisas
Possible decryption with key goi: Npyyy emod mmizzh qejyiwt ctyn wsm jyinas
Possible decryption with key gom: Npuyy emkd imivzh qefyist ytyj wom fyijas
Possible decryption with key gop: Npryy emhd fmiszh qecyipt vtyg wlm cyigas
Possible decryption with key gor: Nppyy emfd dmiqzh qeayint ttye wjm ayieas
Possible decryption with key gou: Npmyy emcd aminzh qexyikt qtyb wgm xyibas
Possible decryption with key gpb: Nofyx elvd tmhgzg qdqyhdt jtxu vzm qyhuar
Possible decryption with key grm: Nmuyv ejkd imfvze qbfyfst ytvj tom fyfjap
Possible decryption with key gse: Nlcyu eisd qmedzd qanyeat gtur swm nyerao
Possible decryption with key gsj: Nlxyu eind lmeyzd qaiyevt btum srm iyemao
Possible decryption with key gth: Nkzyt ehpd nmdazc qzkydxt dtto rtm kydoan
Possible decryption with key gvo: Nisyr efid gmbtza qxdybqt wtrh pmm dybhal
Possible decryption with key gvt: Ninyr efdd bmboza qxyyblt rtrc phm yybcal
Possible decryption with key gwv: Nhlyq eebd zmamzz qwwyajt ptqa ofm wyaaak
Possible decryption with key gya: Nfgyo ecwd umyhzx quryyet ktov mam ryyvai
Possible decryption with key gyb: Nffyo ecvd tmygzx quqyydt jtou mzm qyyuai
Possible decryption with key gyc: Nfeyo ecud smyfzx qupyyct itot mym pyytai
Possible decryption with key gyd: Nfdyo ectd rmyezx quoyybt htos mxm oyysai
Possible decryption with key gye: Nfcyo ecsd qmydzx qunyyat gtor mwm nyyrai
Possible decryption with key gyf: Nfbyo ecrd pmyczx qumyyzt ftoq mvm myyqai
Possible decryption with key gyg: Nfayo ecqd omybzx qulyyyt etop mum lyypai
Possible decryption with key gyh: Nfzyo ecpd nmyazx qukyyxt dtoo mtm kyyoai
Possible decryption with key gyi: Nfyyo ecod mmyzzx qujyywt cton msm jyynai
Possible decryption with key gyj: Nfxyo ecnd lmyyzx quiyyvt btom mrm iyymai
Possible decryption with key gyk: Nfwyo ecmd kmyxzx quhyyut atol mqm hyylai
Possible decryption with key gyl: Nfvyo ecld jmywzx qugyytt ztok mpm gyykai
Possible decryption with key gym: Nfuyo eckd imyvzx qufyyst ytoj mom fyyjai
Possible decryption with key gyn: Nftyo ecjd hmyuzx queyyrt xtoi mnm eyyiai
Possible decryption with key gyo: Nfsyo ecid gmytzx qudyyqt wtoh mmm dyyhai
Possible decryption with key gyp: Nfryo echd fmyszx qucyypt vtog mlm cyygai
Possible decryption with key gyq: Nfqyo ecgd emyrzx qubyyot utof mkm byyfai
Possible decryption with key gyr: Nfpyo ecfd dmyqzx quayynt ttoe mjm ayyeai
Possible decryption with key gys: Nfoyo eced cmypzx quzyymt stod mim zyydai
Possible decryption with key gyt: Nfnyo ecdd bmyozx quyyylt rtoc mhm yyycai
Possible decryption with key gyu: Nfmyo eccd amynzx quxyykt qtob mgm xyybai
Possible decryption with key gyv: Nflyo ecbd zmymzx quwyyjt ptoa mfm wyyaai
Possible decryption with key gyw: Nfkyo ecad ymylzx quvyyit otoz mem vyyzai
Possible decryption with key gyx: Nfjyo eczd xmykzx quuyyht ntoy mdm uyyyai
Possible decryption with key gyy: Nfiyo ecyd wmyjzx qutyygt mtox mcm tyyxai
Possible decryption with key gyz: Nfhyo ecxd vmyizx qusyyft ltow mbm syywai
Possible decryption with key gzd: Nedyn ebtd rmxezw qtoyxbt htns lxm oyxsah
Possible decryption with key hac: Mdexm dauc slwfyv pspxwcs ismt kyl pxwtzg
Possible decryption with key haw: Mdkxm daac ylwlyv psvxwis osmz kel vxwzzg
Possible decryption with key hbc: Mcexl dzuc slvfyu prpxvcs islt jyl pxvtzf
Possible decryption with key hbw: Mckxl dzac ylvlyu prvxvis oslz jel vxvzzf
Possible decryption with key hcc: Mbexk dyuc slufyt pqpxucs iskt iyl pxutze
Possible decryption with key hci: Mbyxk dyoc mluzyt pqjxuws cskn isl jxunze
Possible decryption with key hcn: Mbtxk dyjc hluuyt pqexurs xski inl exuize
Possible decryption with key hcw: Mbkxk dyac ylulyt pqvxuis oskz iel vxuzze
Possible decryption with key hdc: Maexj dxuc sltfys pppxtcs isjt hyl pxttzd
Possible decryption with key hdh: Mazxj dxpc nltays ppkxtxs dsjo htl kxtozd
Possible decryption with key hdq: Maqxj dxgc eltrys ppbxtos usjf hkl bxtfzd
Possible decryption with key hdt: Manxj dxdc bltoys ppyxtls rsjc hhl yxtczd
Possible decryption with key hdw: Makxj dxac yltlys ppvxtis osjz hel vxtzzd
Possible decryption with key hec: Mzexi dwuc slsfyr popxscs isit gyl pxstzc
Possible decryption with key hed: Mzdxi dwtc rlseyr pooxsbs hsis gxl oxsszc
Possible decryption with key hei: Mzyxi dwoc mlszyr pojxsws csin gsl jxsnzc
Possible decryption with key hem: Mzuxi dwkc ilsvyr pofxsss ysij gol fxsjzc
Possible decryption with key hew: Mzkxi dwac ylslyr povxsis osiz gel vxszzc
Possible decryption with key hfc: Myexh dvuc slrfyq pnpxrcs isht fyl pxrtzb
Possible decryption with key hfw: Mykxh dvac ylrlyq pnvxris oshz fel vxrzzb
Possible decryption with key hgc: Mxexg duuc slqfyp pmpxqcs isgt eyl pxqtza
Possible decryption with key hgw: Mxkxg duac ylqlyp pmvxqis osgz eel vxqzza
Possible decryption with key hhc: Mwexf dtuc slpfyo plpxpcs isft dyl pxptzz
Possible decryption with key hhi: Mwyxf dtoc mlpzyo pljxpws csfn dsl jxpnzz
Possible decryption with key hhw: Mwkxf dtac ylplyo plvxpis osfz del vxpzzz
Possible decryption with key hic: Mvexe dsuc slofyn pkpxocs iset cyl pxotzy
Possible decryption with key hiq: Mvqxe dsgc eloryn pkbxoos usef ckl bxofzy
Possible decryption with key hiw: Mvkxe dsac ylolyn pkvxois osez cel vxozzy
Possible decryption with key hiz: Mvhxe dsxc vloiyn pksxofs lsew cbl sxowzy
Possible decryption with key hjc: Muexd druc slnfym pjpxncs isdt byl pxntzx
Possible decryption with key hjw: Mukxd drac ylnlym pjvxnis osdz bel vxnzzx
Possible decryption with key hkc: Mtexc dquc slmfyl pipxmcs isct ayl pxmtzw
Possible decryption with key hke: Mtcxc dqsc qlmdyl pinxmas gscr awl nxmrzw
Possible decryption with key hks: Mtoxc dqec clmpyl pizxmms sscd ail zxmdzw
Possible decryption with key hkw: Mtkxc dqac ylmlyl pivxmis oscz ael vxmzzw
Possible decryption with key hkz: Mthxc dqxc vlmiyl pisxmfs lscw abl sxmwzw
Possible decryption with key hlc: Msexb dpuc sllfyk phpxlcs isbt zyl pxltzv
Possible decryption with key hlw: Mskxb dpac ylllyk phvxlis osbz zel vxlzzv
Possible decryption with key hmc: Mrexa douc slkfyj pgpxkcs isat yyl pxktzu
Possible decryption with key hmr: Mrpxa dofc dlkqyj pgaxkns tsae yjl axkezu
Possible decryption with key hmw: Mrkxa doac ylklyj pgvxkis osaz yel vxkzzu
Possible decryption with key hnc: Mqexz dnuc sljfyi pfpxjcs iszt xyl pxjtzt
Possible decryption with key hnw: Mqkxz dnac yljlyi pfvxjis oszz xel vxjzzt
Possible decryption with key hoc: Mpexy dmuc slifyh pepxics isyt wyl pxitzs
Possible decryption with key hod: Mpdxy dmtc rlieyh peoxibs hsys wxl oxiszs
Possible decryption with key hoi: Mpyxy dmoc mlizyh pejxiws csyn wsl jxinzs
Possible decryption with key hom: Mpuxy dmkc ilivyh pefxiss ysyj wol fxijzs
Possible decryption with key hop: Mprxy dmhc flisyh pecxips vsyg wll cxigzs
Possible decryption with key hor: Mppxy dmfc dliqyh peaxins tsye wjl axiezs
Possible decryption with key hou: Mpmxy dmcc alinyh pexxiks qsyb wgl xxibzs
Possible decryption with key how: Mpkxy dmac ylilyh pevxiis osyz wel vxizzs
Possible decryption with key hpb: Mofxx dlvc tlhgyg pdqxhds jsxu vzl qxhuzr
Possible decryption with key hpc: Moexx dluc slhfyg pdpxhcs isxt vyl pxhtzr
Possible decryption with key hpw: Mokxx dlac ylhlyg pdvxhis osxz vel vxhzzr
Possible decryption with key hqc: Mnexw dkuc slgfyf pcpxgcs iswt uyl pxgtzq
Possible decryption with key hqw: Mnkxw dkac ylglyf pcvxgis oswz uel vxgzzq
Possible decryption with key hrc: Mmexv djuc slffye pbpxfcs isvt tyl pxftzp
Possible decryption with key hrm: Mmuxv djkc ilfvye pbfxfss ysvj tol fxfjzp
Possible decryption with key hrw: Mmkxv djac ylflye pbvxfis osvz tel vxfzzp
Possible decryption with key hsc: Mlexu diuc slefyd papxecs isut syl pxetzo
Possible decryption with key hse: Mlcxu disc qledyd panxeas gsur swl nxerzo
Possible decryption with key hsj: Mlxxu dinc lleyyd paixevs bsum srl ixemzo
Possible decryption with key hsw: Mlkxu diac ylelyd pavxeis osuz sel vxezzo
Possible decryption with key htc: Mkext dhuc sldfyc pzpxdcs istt ryl pxdtzn
Possible decryption with key hth: Mkzxt dhpc nldayc pzkxdxs dsto rtl kxdozn
Possible decryption with key htw: Mkkxt dhac yldlyc pzvxdis ostz rel vxdzzn
Possible decryption with key huc: Mjexs dguc slcfyb pypxccs isst qyl pxctzm
Possible decryption with key huw: Mjkxs dgac ylclyb pyvxcis ossz qel vxczzm
Possible decryption with key hvc: Miexr dfuc slbfya pxpxbcs isrt pyl pxbtzl
Possible decryption with key hvo: Misxr dfic glbtya pxdxbqs wsrh pml dxbhzl
Possible decryption with key hvt: Minxr dfdc blboya pxyxbls rsrc phl yxbczl
Possible decryption with key hvw: Mikxr dfac ylblya pxvxbis osrz pel vxbzzl
Possible decryption with key hwc: Mhexq deuc slafyz pwpxacs isqt oyl pxatzk
Possible decryption with key hwv: Mhlxq debc zlamyz pwwxajs psqa ofl wxaazk
Possible decryption with key hww: Mhkxq deac ylalyz pwvxais osqz oel vxazzk
Possible decryption with key hxc: Mgexp dduc slzfyy pvpxzcs ispt nyl pxztzj
Possible decryption with key hxw: Mgkxp ddac ylzlyy pvvxzis ospz nel vxzzzj
Possible decryption with key hyc: Mfexo dcuc slyfyx pupxycs isot myl pxytzi
Possible decryption with key hyq: Mfqxo dcgc elyryx pubxyos usof mkl bxyfzi
Possible decryption with key hyw: Mfkxo dcac ylylyx puvxyis osoz mel vxyzzi
Possible decryption with key hzc: Meexn dbuc slxfyw ptpxxcs isnt lyl pxxtzh
Possible decryption with key hzd: Medxn dbtc rlxeyw ptoxxbs hsns lxl oxxszh
Possible decryption with key hzw: Mekxn dbac ylxlyw ptvxxis osnz lel vxxzzh
Possible decryption with key ici: Lbywk cyob mkuzxt oqjwuwr crkn isk jwunye
Possible decryption with key icn: Lbtwk cyjb hkuuxt oqewurr xrki ink ewuiye
Possible decryption with key idh: Lazwj cxpb nktaxs opkwtxr drjo htk kwtoyd
Possible decryption with key idq: Laqwj cxgb ektrxs opbwtor urjf hkk bwtfyd
Possible decryption with key idt: Lanwj cxdb bktoxs opywtlr rrjc hhk ywtcyd
Possible decryption with key ied: Lzdwi cwtb rksexr ooowsbr hris gxk owssyc
Possible decryption with key iei: Lzywi cwob mkszxr oojwswr crin gsk jwsnyc
Possible decryption with key iem: Lzuwi cwkb iksvxr oofwssr yrij gok fwsjyc
Possible decryption with key ihi: Lwywf ctob mkpzxo oljwpwr crfn dsk jwpnyz
Possible decryption with key iic: Lvewe csub skofxn okpwocr iret cyk pwotyy
Possible decryption with key iiq: Lvqwe csgb ekorxn okbwoor uref ckk bwofyy
Possible decryption with key iiz: Lvhwe csxb vkoixn okswofr lrew cbk swowyy
Possible decryption with key ike: Ltcwc cqsb qkmdxl oinwmar grcr awk nwmryw
Possible decryption with key iks: Ltowc cqeb ckmpxl oizwmmr srcd aik zwmdyw
Possible decryption with key ikz: Lthwc cqxb vkmixl oiswmfr lrcw abk swmwyw
Possible decryption with key imr: Lrpwa cofb dkkqxj ogawknr trae yjk awkeyu
Possible decryption with key ina: Lqgwz cnwb ukjhxi ofrwjer krzv xak rwjvyt
Possible decryption with key inb: Lqfwz cnvb tkjgxi ofqwjdr jrzu xzk qwjuyt
Possible decryption with key inc: Lqewz cnub skjfxi ofpwjcr irzt xyk pwjtyt
Possible decryption with key ind: Lqdwz cntb rkjexi ofowjbr hrzs xxk owjsyt
Possible decryption with key ine: Lqcwz cnsb qkjdxi ofnwjar grzr xwk nwjryt
Possible decryption with key inf: Lqbwz cnrb pkjcxi ofmwjzr frzq xvk mwjqyt
Possible decryption with key ing: Lqawz cnqb okjbxi oflwjyr erzp xuk lwjpyt
Possible decryption with key inh: Lqzwz cnpb nkjaxi ofkwjxr drzo xtk kwjoyt
Possible decryption with key ini: Lqywz cnob mkjzxi ofjwjwr crzn xsk jwjnyt
Possible decryption with key inj: Lqxwz cnnb lkjyxi ofiwjvr brzm xrk iwjmyt
Possible decryption with key ink: Lqwwz cnmb kkjxxi ofhwjur arzl xqk hwjlyt
Possible decryption with key inl: Lqvwz cnlb jkjwxi ofgwjtr zrzk xpk gwjkyt
Possible decryption with key inm: Lquwz cnkb ikjvxi offwjsr yrzj xok fwjjyt
Possible decryption with key inn: Lqtwz cnjb hkjuxi ofewjrr xrzi xnk ewjiyt
Possible decryption with key ino: Lqswz cnib gkjtxi ofdwjqr wrzh xmk dwjhyt
Possible decryption with key inp: Lqrwz cnhb fkjsxi ofcwjpr vrzg xlk cwjgyt
Possible decryption with key inq: Lqqwz cngb ekjrxi ofbwjor urzf xkk bwjfyt
Possible decryption with key inr: Lqpwz cnfb dkjqxi ofawjnr trze xjk awjeyt
Possible decryption with key ins: Lqowz cneb ckjpxi ofzwjmr srzd xik zwjdyt
Possible decryption with key int: Lqnwz cndb bkjoxi ofywjlr rrzc xhk ywjcyt
Possible decryption with key inu: Lqmwz cncb akjnxi ofxwjkr qrzb xgk xwjbyt
Possible decryption with key inv: Lqlwz cnbb zkjmxi ofwwjjr prza xfk wwjayt
Possible decryption with key inw: Lqkwz cnab ykjlxi ofvwjir orzz xek vwjzyt
Possible decryption with key inx: Lqjwz cnzb xkjkxi ofuwjhr nrzy xdk uwjyyt
Possible decryption with key iny: Lqiwz cnyb wkjjxi oftwjgr mrzx xck twjxyt
Possible decryption with key inz: Lqhwz cnxb vkjixi ofswjfr lrzw xbk swjwyt
Possible decryption with key iod: Lpdwy cmtb rkiexh oeowibr hrys wxk owisys
Possible decryption with key ioi: Lpywy cmob mkizxh oejwiwr cryn wsk jwinys
Possible decryption with key iom: Lpuwy cmkb ikivxh oefwisr yryj wok fwijys
Possible decryption with key iop: Lprwy cmhb fkisxh oecwipr vryg wlk cwigys
Possible decryption with key ior: Lppwy cmfb dkiqxh oeawinr trye wjk awieys
Possible decryption with key iou: Lpmwy cmcb akinxh oexwikr qryb wgk xwibys
Possible decryption with key ipb: Lofwx clvb tkhgxg odqwhdr jrxu vzk qwhuyr
Possible decryption with key irm: Lmuwv cjkb ikfvxe obfwfsr yrvj tok fwfjyp
Possible decryption with key ise: Llcwu cisb qkedxd oanwear grur swk nweryo
Possible decryption with key isj: Llxwu cinb lkeyxd oaiwevr brum srk iwemyo
Possible decryption with key ith: Lkzwt chpb nkdaxc ozkwdxr drto rtk kwdoyn
Possible decryption with key ivo: Liswr cfib gkbtxa oxdwbqr wrrh pmk dwbhyl
Possible decryption with key ivt: Linwr cfdb bkboxa oxywblr rrrc phk ywbcyl
Possible decryption with key iwv: Lhlwq cebb zkamxz owwwajr prqa ofk wwaayk
Possible decryption with key iyq: Lfqwo ccgb ekyrxx oubwyor urof mkk bwyfyi
Possible decryption with key izd: Ledwn cbtb rkxexw otowxbr hrns lxk owxsyh
Possible decryption with key jci: Kbyvk byoa mjuzwt nqjvuwq cqkn isj jvunxe
Possible decryption with key jcn: Kbtvk byja hjuuwt nqevurq xqki inj evuixe
Possible decryption with key jdh: Kazvj bxpa njtaws npkvtxq dqjo htj kvtoxd
Possible decryption with key jdq: Kaqvj bxga ejtrws npbvtoq uqjf hkj bvtfxd
Possible decryption with key jdt: Kanvj bxda bjtows npyvtlq rqjc hhj yvtcxd
Possible decryption with key jed: Kzdvi bwta rjsewr noovsbq hqis gxj ovssxc
Possible decryption with key jei: Kzyvi bwoa mjszwr nojvswq cqin gsj jvsnxc
Possible decryption with key jem: Kzuvi bwka ijsvwr nofvssq yqij goj fvsjxc
Possible decryption with key jhi: Kwyvf btoa mjpzwo nljvpwq cqfn dsj jvpnxz
Possible decryption with key jic: Kveve bsua sjofwn nkpvocq iqet cyj pvotxy
Possible decryption with key jiq: Kvqve bsga ejorwn nkbvooq uqef ckj bvofxy
Possible decryption with key jiz: Kvhve bsxa vjoiwn nksvofq lqew cbj svowxy
Possible decryption with key jke: Ktcvc bqsa qjmdwl ninvmaq gqcr awj nvmrxw
Possible decryption with key jks: Ktovc bqea cjmpwl nizvmmq sqcd aij zvmdxw
Possible decryption with key jkz: Kthvc bqxa vjmiwl nisvmfq lqcw abj svmwxw
Possible decryption with key jmr: Krpva bofa djkqwj ngavknq tqae yjj avkexu
Possible decryption with key jod: Kpdvy bmta rjiewh neovibq hqys wxj ovisxs
Possible decryption with key joi: Kpyvy bmoa mjizwh nejviwq cqyn wsj jvinxs
Possible decryption with key jom: Kpuvy bmka ijivwh nefvisq yqyj woj fvijxs
Possible decryption with key jop: Kprvy bmha fjiswh necvipq vqyg wlj cvigxs
Possible decryption with key jor: Kppvy bmfa djiqwh neavinq tqye wjj aviexs
Possible decryption with key jou: Kpmvy bmca ajinwh nexvikq qqyb wgj xvibxs
Possible decryption with key jpb: Kofvx blva tjhgwg ndqvhdq jqxu vzj qvhuxr
Possible decryption with key jrm: Kmuvv bjka ijfvwe nbfvfsq yqvj toj fvfjxp
Possible decryption with key jse: Klcvu bisa qjedwd nanveaq gqur swj nverxo
Possible decryption with key jsj: Klxvu bina ljeywd naivevq bqum srj ivemxo
Possible decryption with key jth: Kkzvt bhpa njdawc nzkvdxq dqto rtj kvdoxn
Possible decryption with key jvo: Kisvr bfia gjbtwa nxdvbqq wqrh pmj dvbhxl
Possible decryption with key jvt: Kinvr bfda bjbowa nxyvblq rqrc phj yvbcxl
Possible decryption with key jwv: Khlvq beba zjamwz nwwvajq pqqa ofj wvaaxk
Possible decryption with key jyq: Kfqvo bcga ejyrwx nubvyoq uqof mkj bvyfxi
Possible decryption with key jzd: Kedvn bbta rjxeww ntovxbq hqns lxj ovxsxh
Possible decryption with key kci: Jbyuk ayoz miuzvt mqjuuwp cpkn isi juunwe
Possible decryption with key kcn: Jbtuk ayjz hiuuvt mqeuurp xpki ini euuiwe
Possible decryption with key kdh: Jazuj axpz nitavs mpkutxp dpjo hti kutowd
Possible decryption with key kdq: Jaquj axgz eitrvs mpbutop upjf hki butfwd
Possible decryption with key kdt: Januj axdz bitovs mpyutlp rpjc hhi yutcwd
Possible decryption with key kea: Jzgui awwz uishvr morusep kpiv gai rusvwc
Possible decryption with key keb: Jzfui awvz tisgvr moqusdp jpiu gzi qusuwc
Possible decryption with key kec: Jzeui awuz sisfvr mopuscp ipit gyi pustwc
Possible decryption with key ked: Jzdui awtz risevr moousbp hpis gxi ousswc
Possible decryption with key kee: Jzcui awsz qisdvr monusap gpir gwi nusrwc
Possible decryption with key kef: Jzbui awrz piscvr momuszp fpiq gvi musqwc
Possible decryption with key keg: Jzaui awqz oisbvr molusyp epip gui luspwc
Possible decryption with key keh: Jzzui awpz nisavr mokusxp dpio gti kusowc
Possible decryption with key kei: Jzyui awoz miszvr mojuswp cpin gsi jusnwc
Possible decryption with key kej: Jzxui awnz lisyvr moiusvp bpim gri iusmwc
Possible decryption with key kek: Jzwui awmz kisxvr mohusup apil gqi huslwc
Possible decryption with key kel: Jzvui awlz jiswvr mogustp zpik gpi guskwc
Possible decryption with key kem: Jzuui awkz iisvvr mofussp ypij goi fusjwc
Possible decryption with key ken: Jztui awjz hisuvr moeusrp xpii gni eusiwc
Possible decryption with key keo: Jzsui awiz gistvr modusqp wpih gmi dushwc
Possible decryption with key kep: Jzrui awhz fissvr mocuspp vpig gli cusgwc
Possible decryption with key keq: Jzqui awgz eisrvr mobusop upif gki busfwc
Possible decryption with key ker: Jzpui awfz disqvr moausnp tpie gji ausewc
Possible decryption with key kes: Jzoui awez cispvr mozusmp spid gii zusdwc
Possible decryption with key ket: Jznui awdz bisovr moyuslp rpic ghi yuscwc
Possible decryption with key keu: Jzmui awcz aisnvr moxuskp qpib ggi xusbwc
Possible decryption with key kev: Jzlui awbz zismvr mowusjp ppia gfi wusawc
Possible decryption with key kew: Jzkui awaz yislvr movusip opiz gei vuszwc
Possible decryption with key kex: Jzjui awzz xiskvr mouushp npiy gdi uusywc
Possible decryption with key key: Jziui awyz wisjvr motusgp mpix gci tusxwc
Possible decryption with key kez: Jzhui awxz visivr mosusfp lpiw gbi suswwc
Possible decryption with key khi: Jwyuf atoz mipzvo mljupwp cpfn dsi jupnwz
Possible decryption with key kic: Jveue asuz siofvn mkpuocp ipet cyi puotwy
Possible decryption with key kiq: Jvque asgz eiorvn mkbuoop upef cki buofwy
Possible decryption with key kiz: Jvhue asxz vioivn mksuofp lpew cbi suowwy
Possible decryption with key kja: Jugud arwz uinhvm mjrunep kpdv bai runvwx
Possible decryption with key kjb: Jufud arvz tingvm mjqundp jpdu bzi qunuwx
Possible decryption with key kjc: Jueud aruz sinfvm mjpuncp ipdt byi puntwx
Possible decryption with key kjd: Judud artz rinevm mjounbp hpds bxi ounswx
Possible decryption with key kje: Jucud arsz qindvm mjnunap gpdr bwi nunrwx
Possible decryption with key kjf: Jubud arrz pincvm mjmunzp fpdq bvi munqwx
Possible decryption with key kjg: Juaud arqz oinbvm mjlunyp epdp bui lunpwx
Possible decryption with key kjh: Juzud arpz ninavm mjkunxp dpdo bti kunowx
Possible decryption with key kji: Juyud aroz minzvm mjjunwp cpdn bsi junnwx
Possible decryption with key kjj: Juxud arnz linyvm mjiunvp bpdm bri iunmwx
Possible decryption with key kjk: Juwud armz kinxvm mjhunup apdl bqi hunlwx
Possible decryption with key kjl: Juvud arlz jinwvm mjguntp zpdk bpi gunkwx
Possible decryption with key kjm: Juuud arkz iinvvm mjfunsp ypdj boi funjwx
Possible decryption with key kjn: Jutud arjz hinuvm mjeunrp xpdi bni euniwx
Possible decryption with key kjo: Jusud ariz gintvm mjdunqp wpdh bmi dunhwx
Possible decryption with key kjp: Jurud arhz finsvm mjcunpp vpdg bli cungwx
Possible decryption with key kjq: Juqud argz einrvm mjbunop updf bki bunfwx
Possible decryption with key kjr: Jupud arfz dinqvm mjaunnp tpde bji aunewx
Possible decryption with key kjs: Juoud arez cinpvm mjzunmp spdd bii zundwx
Possible decryption with key kjt: Junud ardz binovm mjyunlp rpdc bhi yuncwx
Possible decryption with key kju: Jumud arcz ainnvm mjxunkp qpdb bgi xunbwx
Possible decryption with key kjv: Julud arbz zinmvm mjwunjp ppda bfi wunawx
Possible decryption with key kjw: Jukud araz yinlvm mjvunip opdz bei vunzwx
Possible decryption with key kjx: Jujud arzz xinkvm mjuunhp npdy bdi uunywx
Possible decryption with key kjy: Juiud aryz winjvm mjtungp mpdx bci tunxwx
Possible decryption with key kjz: Juhud arxz vinivm mjsunfp lpdw bbi sunwwx
Possible decryption with key kke: Jtcuc aqsz qimdvl minumap gpcr awi numrww
Possible decryption with key kks: Jtouc aqez cimpvl mizummp spcd aii zumdww
Possible decryption with key kkz: Jthuc aqxz vimivl misumfp lpcw abi sumwww
Possible decryption with key kmr: Jrpua aofz dikqvj mgauknp tpae yji aukewu
Possible decryption with key knt: Jqnuz andz bijovi mfyujlp rpzc xhi yujcwt
Possible decryption with key kod: Jpduy amtz riievh meouibp hpys wxi ouisws
Possible decryption with key koi: Jpyuy amoz miizvh mejuiwp cpyn wsi juinws
Possible decryption with key kom: Jpuuy amkz iiivvh mefuisp ypyj woi fuijws
Possible decryption with key kop: Jpruy amhz fiisvh mecuipp vpyg wli cuigws
Possible decryption with key kor: Jppuy amfz diiqvh meauinp tpye wji auiews
Possible decryption with key kou: Jpmuy amcz aiinvh mexuikp qpyb wgi xuibws
Possible decryption with key kpb: Jofux alvz tihgvg mdquhdp jpxu vzi quhuwr
Possible decryption with key krm: Jmuuv ajkz iifvve mbfufsp ypvj toi fufjwp
Possible decryption with key kse: Jlcuu aisz qiedvd manueap gpur swi nuerwo
Possible decryption with key ksj: Jlxuu ainz lieyvd maiuevp bpum sri iuemwo
Possible decryption with key kth: Jkzut ahpz nidavc mzkudxp dpto rti kudown
Possible decryption with key kvo: Jisur afiz gibtva mxdubqp wprh pmi dubhwl
Possible decryption with key kvt: Jinur afdz bibova mxyublp rprc phi yubcwl
Possible decryption with key kwv: Jhluq aebz ziamvz mwwuajp ppqa ofi wuaawk
Possible decryption with key kyq: Jfquo acgz eiyrvx mubuyop upof mki buyfwi
Possible decryption with key kzd: Jedun abtz rixevw mtouxbp hpns lxi ouxswh
Possible decryption with key lal: Idvtm zaly jhwwuv lsgtwto zomk kph gtwkvg
Possible decryption with key lar: Idptm zafy dhwquv lsatwno tome kjh atwevg
Possible decryption with key lbl: Icvtl zzly jhvwuu lrgtvto zolk jph gtvkvf
Possible decryption with key lbr: Icptl zzfy dhvquu lratvno tole jjh atvevf
Possible decryption with key lci: Ibytk zyoy mhuzut lqjtuwo cokn ish jtunve
Possible decryption with key lcl: Ibvtk zyly jhuwut lqgtuto zokk iph gtukve
Possible decryption with key lcn: Ibttk zyjy hhuuut lqeturo xoki inh etuive
Possible decryption with key lcr: Ibptk zyfy dhuqut lqatuno toke ijh atueve
Possible decryption with key ldh: Iaztj zxpy nhtaus lpkttxo dojo hth kttovd
Possible decryption with key ldl: Iavtj zxly jhtwus lpgttto zojk hph gttkvd
Possible decryption with key ldq: Iaqtj zxgy ehtrus lpbttoo uojf hkh bttfvd
Possible decryption with key ldr: Iaptj zxfy dhtqus lpattno toje hjh attevd
Possible decryption with key ldt: Iantj zxdy bhtous lpyttlo rojc hhh yttcvd
Possible decryption with key led: Izdti zwty rhseur lootsbo hois gxh otssvc
Possible decryption with key lei: Izyti zwoy mhszur lojtswo coin gsh jtsnvc
Possible decryption with key lel: Izvti zwly jhswur logtsto zoik gph gtskvc
Possible decryption with key lem: Izuti zwky ihsvur loftsso yoij goh ftsjvc
Possible decryption with key ler: Izpti zwfy dhsqur loatsno toie gjh atsevc
Possible decryption with key lfl: Iyvth zvly jhrwuq lngtrto zohk fph gtrkvb
Possible decryption with key lfr: Iypth zvfy dhrquq lnatrno tohe fjh atrevb
Possible decryption with key lgl: Ixvtg zuly jhqwup lmgtqto zogk eph gtqkva
Possible decryption with key lgr: Ixptg zufy dhqqup lmatqno toge ejh atqeva
Possible decryption with key lha: Iwgtf ztwy uhphuo llrtpeo kofv dah rtpvvz
Possible decryption with key lhb: Iwftf ztvy thpguo llqtpdo jofu dzh qtpuvz
Possible decryption with key lhc: Iwetf ztuy shpfuo llptpco ioft dyh ptptvz
Possible decryption with key lhd: Iwdtf ztty rhpeuo llotpbo hofs dxh otpsvz
Possible decryption with key lhe: Iwctf ztsy qhpduo llntpao gofr dwh ntprvz
Possible decryption with key lhf: Iwbtf ztry phpcuo llmtpzo fofq dvh mtpqvz
Possible decryption with key lhg: Iwatf ztqy ohpbuo llltpyo eofp duh ltppvz
Possible decryption with key lhh: Iwztf ztpy nhpauo llktpxo dofo dth ktpovz
Possible decryption with key lhi: Iwytf ztoy mhpzuo lljtpwo cofn dsh jtpnvz
Possible decryption with key lhj: Iwxtf ztny lhpyuo llitpvo bofm drh itpmvz
Possible decryption with key lhk: Iwwtf ztmy khpxuo llhtpuo aofl dqh htplvz
Possible decryption with key lhl: Iwvtf ztly jhpwuo llgtpto zofk dph gtpkvz
Possible decryption with key lhm: Iwutf ztky ihpvuo llftpso yofj doh ftpjvz
Possible decryption with key lhn: Iwttf ztjy hhpuuo lletpro xofi dnh etpivz
Possible decryption with key lho: Iwstf ztiy ghptuo lldtpqo wofh dmh dtphvz
Possible decryption with key lhp: Iwrtf zthy fhpsuo llctppo vofg dlh ctpgvz
Possible decryption with key lhq: Iwqtf ztgy ehpruo llbtpoo uoff dkh btpfvz
Possible decryption with key lhr: Iwptf ztfy dhpquo llatpno tofe djh atpevz
Possible decryption with key lhs: Iwotf ztey chppuo llztpmo sofd dih ztpdvz
Possible decryption with key lht: Iwntf ztdy bhpouo llytplo rofc dhh ytpcvz
Possible decryption with key lhu: Iwmtf ztcy ahpnuo llxtpko qofb dgh xtpbvz
Possible decryption with key lhv: Iwltf ztby zhpmuo llwtpjo pofa dfh wtpavz
Possible decryption with key lhw: Iwktf ztay yhpluo llvtpio oofz deh vtpzvz
Possible decryption with key lhx: Iwjtf ztzy xhpkuo llutpho nofy ddh utpyvz
Possible decryption with key lhy: Iwitf ztyy whpjuo llttpgo mofx dch ttpxvz
Possible decryption with key lhz: Iwhtf ztxy vhpiuo llstpfo lofw dbh stpwvz
Possible decryption with key lia: Ivgte zswy uhohun lkrtoeo koev cah rtovvy
Possible decryption with key lib: Ivfte zsvy thogun lkqtodo joeu czh qtouvy
Possible decryption with key lic: Ivete zsuy shofun lkptoco ioet cyh ptotvy
Possible decryption with key lid: Ivdte zsty rhoeun lkotobo hoes cxh otosvy
Possible decryption with key lie: Ivcte zssy qhodun lkntoao goer cwh ntorvy
Possible decryption with key lif: Ivbte zsry phocun lkmtozo foeq cvh mtoqvy
Possible decryption with key lig: Ivate zsqy ohobun lkltoyo eoep cuh ltopvy
Possible decryption with key lih: Ivzte zspy nhoaun lkktoxo doeo cth ktoovy
Possible decryption with key lii: Ivyte zsoy mhozun lkjtowo coen csh jtonvy
Possible decryption with key lij: Ivxte zsny lhoyun lkitovo boem crh itomvy
Possible decryption with key lik: Ivwte zsmy khoxun lkhtouo aoel cqh htolvy
Possible decryption with key lil: Ivvte zsly jhowun lkgtoto zoek cph gtokvy
Possible decryption with key lim: Ivute zsky ihovun lkftoso yoej coh ftojvy
Possible decryption with key lin: Ivtte zsjy hhouun lketoro xoei cnh etoivy
Possible decryption with key lio: Ivste zsiy ghotun lkdtoqo woeh cmh dtohvy
Possible decryption with key lip: Ivrte zshy fhosun lkctopo voeg clh ctogvy
Possible decryption with key liq: Ivqte zsgy ehorun lkbtooo uoef ckh btofvy
Possible decryption with key lir: Ivpte zsfy dhoqun lkatono toee cjh atoevy
Possible decryption with key lis: Ivote zsey chopun lkztomo soed cih ztodvy
Possible decryption with key lit: Ivnte zsdy bhooun lkytolo roec chh ytocvy
Possible decryption with key liu: Ivmte zscy ahonun lkxtoko qoeb cgh xtobvy
Possible decryption with key liv: Ivlte zsby zhomun lkwtojo poea cfh wtoavy
Possible decryption with key liw: Ivkte zsay yholun lkvtoio ooez ceh vtozvy
Possible decryption with key lix: Ivjte zszy xhokun lkutoho noey cdh utoyvy
Possible decryption with key liy: Ivite zsyy whojun lkttogo moex cch ttoxvy
Possible decryption with key liz: Ivhte zsxy vhoiun lkstofo loew cbh stowvy
Possible decryption with key ljl: Iuvtd zrly jhnwum ljgtnto zodk bph gtnkvx
Possible decryption with key ljr: Iuptd zrfy dhnqum ljatnno tode bjh atnevx
Possible decryption with key lke: Itctc zqsy qhmdul lintmao gocr awh ntmrvw
Possible decryption with key lkl: Itvtc zqly jhmwul ligtmto zock aph gtmkvw
Possible decryption with key lkr: Itptc zqfy dhmqul liatmno toce ajh atmevw
Possible decryption with key lks: Itotc zqey chmpul liztmmo socd aih ztmdvw
Possible decryption with key lkz: Ithtc zqxy vhmiul listmfo locw abh stmwvw
Possible decryption with key lla: Isgtb zpwy uhlhuk lhrtleo kobv zah rtlvvv
Possible decryption with key llb: Isftb zpvy thlguk lhqtldo jobu zzh qtluvv
Possible decryption with key llc: Isetb zpuy shlfuk lhptlco iobt zyh ptltvv
Possible decryption with key lld: Isdtb zpty rhleuk lhotlbo hobs zxh otlsvv
Possible decryption with key lle: Isctb zpsy qhlduk lhntlao gobr zwh ntlrvv
Possible decryption with key llf: Isbtb zpry phlcuk lhmtlzo fobq zvh mtlqvv
Possible decryption with key llg: Isatb zpqy ohlbuk lhltlyo eobp zuh ltlpvv
Possible decryption with key llh: Isztb zppy nhlauk lhktlxo dobo zth ktlovv
Possible decryption with key lli: Isytb zpoy mhlzuk lhjtlwo cobn zsh jtlnvv
Possible decryption with key llj: Isxtb zpny lhlyuk lhitlvo bobm zrh itlmvv
Possible decryption with key llk: Iswtb zpmy khlxuk lhhtluo aobl zqh htllvv
Possible decryption with key lll: Isvtb zply jhlwuk lhgtlto zobk zph gtlkvv
Possible decryption with key llm: Isutb zpky ihlvuk lhftlso yobj zoh ftljvv
Possible decryption with key lln: Isttb zpjy hhluuk lhetlro xobi znh etlivv
Possible decryption with key llo: Isstb zpiy ghltuk lhdtlqo wobh zmh dtlhvv
Possible decryption with key llp: Isrtb zphy fhlsuk lhctlpo vobg zlh ctlgvv
Possible decryption with key llq: Isqtb zpgy ehlruk lhbtloo uobf zkh btlfvv
Possible decryption with key llr: Isptb zpfy dhlquk lhatlno tobe zjh atlevv
Possible decryption with key lls: Isotb zpey chlpuk lhztlmo sobd zih ztldvv
Possible decryption with key llt: Isntb zpdy bhlouk lhytllo robc zhh ytlcvv
Possible decryption with key llu: Ismtb zpcy ahlnuk lhxtlko qobb zgh xtlbvv
Possible decryption with key llv: Isltb zpby zhlmuk lhwtljo poba zfh wtlavv
Possible decryption with key llw: Isktb zpay yhlluk lhvtlio oobz zeh vtlzvv
Possible decryption with key llx: Isjtb zpzy xhlkuk lhutlho noby zdh utlyvv
Possible decryption with key lly: Isitb zpyy whljuk lhttlgo mobx zch ttlxvv
Possible decryption with key llz: Ishtb zpxy vhliuk lhstlfo lobw zbh stlwvv
Possible decryption with key lml: Irvta zoly jhkwuj lggtkto zoak yph gtkkvu
Possible decryption with key lmr: Irpta zofy dhkquj lgatkno toae yjh atkevu
Possible decryption with key lnl: Iqvtz znly jhjwui lfgtjto zozk xph gtjkvt
Possible decryption with key lnr: Iqptz znfy dhjqui lfatjno toze xjh atjevt
Possible decryption with key lod: Ipdty zmty rhieuh leotibo hoys wxh otisvs
Possible decryption with key loi: Ipyty zmoy mhizuh lejtiwo coyn wsh jtinvs
Possible decryption with key lol: Ipvty zmly jhiwuh legtito zoyk wph gtikvs
Possible decryption with key lom: Iputy zmky ihivuh leftiso yoyj woh ftijvs
Possible decryption with key lop: Iprty zmhy fhisuh lectipo voyg wlh ctigvs
Possible decryption with key lor: Ippty zmfy dhiquh leatino toye wjh atievs
Possible decryption with key lou: Ipmty zmcy ahinuh lextiko qoyb wgh xtibvs
Possible decryption with key lpa: Iogtx zlwy uhhhug ldrtheo koxv vah rthvvr
Possible decryption with key lpb: Ioftx zlvy thhgug ldqthdo joxu vzh qthuvr
Possible decryption with key lpl: Iovtx zlly jhhwug ldgthto zoxk vph gthkvr
Possible decryption with key lpr: Ioptx zlfy dhhqug ldathno toxe vjh athevr
Possible decryption with key lqa: Ingtw zkwy uhghuf lcrtgeo kowv uah rtgvvq
Possible decryption with key lqb: Inftw zkvy thgguf lcqtgdo jowu uzh qtguvq
Possible decryption with key lqc: Inetw zkuy shgfuf lcptgco iowt uyh ptgtvq
Possible decryption with key lqd: Indtw zkty rhgeuf lcotgbo hows uxh otgsvq
Possible decryption with key lqe: Inctw zksy qhgduf lcntgao gowr uwh ntgrvq
Possible decryption with key lqf: Inbtw zkry phgcuf lcmtgzo fowq uvh mtgqvq
Possible decryption with key lqg: Inatw zkqy ohgbuf lcltgyo eowp uuh ltgpvq
Possible decryption with key lqh: Inztw zkpy nhgauf lcktgxo dowo uth ktgovq
Possible decryption with key lqi: Inytw zkoy mhgzuf lcjtgwo cown ush jtgnvq
Possible decryption with key lqj: Inxtw zkny lhgyuf lcitgvo bowm urh itgmvq
Possible decryption with key lqk: Inwtw zkmy khgxuf lchtguo aowl uqh htglvq
Possible decryption with key lql: Invtw zkly jhgwuf lcgtgto zowk uph gtgkvq
Possible decryption with key lqm: Inutw zkky ihgvuf lcftgso yowj uoh ftgjvq
Possible decryption with key lqn: Inttw zkjy hhguuf lcetgro xowi unh etgivq
Possible decryption with key lqo: Instw zkiy ghgtuf lcdtgqo wowh umh dtghvq
Possible decryption with key lqp: Inrtw zkhy fhgsuf lcctgpo vowg ulh ctggvq
Possible decryption with key lqq: Inqtw zkgy ehgruf lcbtgoo uowf ukh btgfvq
Possible decryption with key lqr: Inptw zkfy dhgquf lcatgno towe ujh atgevq
Possible decryption with key lqs: Inotw zkey chgpuf lcztgmo sowd uih ztgdvq
Possible decryption with key lqt: Inntw zkdy bhgouf lcytglo rowc uhh ytgcvq
Possible decryption with key lqu: Inmtw zkcy ahgnuf lcxtgko qowb ugh xtgbvq
Possible decryption with key lqv: Inltw zkby zhgmuf lcwtgjo powa ufh wtgavq
Possible decryption with key lqw: Inktw zkay yhgluf lcvtgio oowz ueh vtgzvq
Possible decryption with key lqx: Injtw zkzy xhgkuf lcutgho nowy udh utgyvq
Possible decryption with key lqy: Initw zkyy whgjuf lcttggo mowx uch ttgxvq
Possible decryption with key lqz: Inhtw zkxy vhgiuf lcstgfo loww ubh stgwvq
Possible decryption with key lrl: Imvtv zjly jhfwue lbgtfto zovk tph gtfkvp
Possible decryption with key lrm: Imutv zjky ihfvue lbftfso yovj toh ftfjvp
Possible decryption with key lrr: Imptv zjfy dhfque lbatfno tove tjh atfevp
Possible decryption with key lsb: Ilftu zivy thegud laqtedo jouu szh qteuvo
Possible decryption with key lse: Ilctu zisy qhedud lanteao gour swh ntervo
Possible decryption with key lsj: Ilxtu ziny lheyud laitevo boum srh itemvo
Possible decryption with key lsl: Ilvtu zily jhewud lagteto zouk sph gtekvo
Possible decryption with key lsr: Ilptu zify dhequd laateno toue sjh ateevo
Possible decryption with key lth: Ikztt zhpy nhdauc lzktdxo doto rth ktdovn
Possible decryption with key ltl: Ikvtt zhly jhdwuc lzgtdto zotk rph gtdkvn
Possible decryption with key ltr: Ikptt zhfy dhdquc lzatdno tote rjh atdevn
Possible decryption with key lul: Ijvts zgly jhcwub lygtcto zosk qph gtckvm
Possible decryption with key lur: Ijpts zgfy dhcqub lyatcno tose qjh atcevm
Possible decryption with key lvl: Iivtr zfly jhbwua lxgtbto zork pph gtbkvl
Possible decryption with key lvo: Iistr zfiy ghbtua lxdtbqo worh pmh dtbhvl
Possible decryption with key lvr: Iiptr zffy dhbqua lxatbno tore pjh atbevl
Possible decryption with key lvt: Iintr zfdy bhboua lxytblo rorc phh ytbcvl
Possible decryption with key lwl: Ihvtq zely jhawuz lwgtato zoqk oph gtakvk
Possible decryption with key lwr: Ihptq zefy dhaquz lwatano toqe ojh ataevk
Possible decryption with key lwv: Ihltq zeby zhamuz lwwtajo poqa ofh wtaavk
Possible decryption with key lxl: Igvtp zdly jhzwuy lvgtzto zopk nph gtzkvj
Possible decryption with key lxr: Igptp zdfy dhzquy lvatzno tope njh atzevj
Possible decryption with key lya: Ifgto zcwy uhyhux lurtyeo koov mah rtyvvi
Possible decryption with key lyb: Iffto zcvy thygux luqtydo joou mzh qtyuvi
Possible decryption with key lyc: Ifeto zcuy shyfux luptyco ioot myh ptytvi
Possible decryption with key lyd: Ifdto zcty rhyeux luotybo hoos mxh otysvi
Possible decryption with key lye: Ifcto zcsy qhydux luntyao goor mwh ntyrvi
Possible decryption with key lyf: Ifbto zcry phycux lumtyzo fooq mvh mtyqvi
Possible decryption with key lyg: Ifato zcqy ohybux lultyyo eoop muh ltypvi
Possible decryption with key lyh: Ifzto zcpy nhyaux luktyxo dooo mth ktyovi
Possible decryption with key lyi: Ifyto zcoy mhyzux lujtywo coon msh jtynvi
Possible decryption with key lyj: Ifxto zcny lhyyux luityvo boom mrh itymvi
Possible decryption with key lyk: Ifwto zcmy khyxux luhtyuo aool mqh htylvi
Possible decryption with key lyl: Ifvto zcly jhywux lugtyto zook mph gtykvi
Possible decryption with key lym: Ifuto zcky ihyvux luftyso yooj moh ftyjvi
Possible decryption with key lyn: Iftto zcjy hhyuux luetyro xooi mnh etyivi
Possible decryption with key lyo: Ifsto zciy ghytux ludtyqo wooh mmh dtyhvi
Possible decryption with key lyp: Ifrto zchy fhysux luctypo voog mlh ctygvi
Possible decryption with key lyq: Ifqto zcgy ehyrux lubtyoo uoof mkh btyfvi
Possible decryption with key lyr: Ifpto zcfy dhyqux luatyno tooe mjh atyevi
Possible decryption with key lys: Ifoto zcey chypux luztymo sood mih ztydvi
Possible decryption with key lyt: Ifnto zcdy bhyoux luytylo rooc mhh ytycvi
Possible decryption with key lyu: Ifmto zccy ahynux luxtyko qoob mgh xtybvi
Possible decryption with key lyv: Iflto zcby zhymux luwtyjo pooa mfh wtyavi
Possible decryption with key lyw: Ifkto zcay yhylux luvtyio oooz meh vtyzvi
Possible decryption with key lyx: Ifjto zczy xhykux luutyho nooy mdh utyyvi
Possible decryption with key lyy: Ifito zcyy whyjux luttygo moox mch ttyxvi
Possible decryption with key lyz: Ifhto zcxy vhyiux lustyfo loow mbh stywvi
Possible decryption with key lzd: Iedtn zbty rhxeuw ltotxbo hons lxh otxsvh
Possible decryption with key lzl: Ievtn zbly jhxwuw ltgtxto zonk lph gtxkvh
Possible decryption with key lzr: Ieptn zbfy dhxquw ltatxno tone ljh atxevh
Possible decryption with key mac: Hdesm yaux sgwftv kspswcn inmt kyg pswtug
Possible decryption with key maj: Hdxsm yanx lgwytv ksiswvn bnmm krg iswmug
Possible decryption with key maw: Hdksm yaax ygwltv ksvswin onmz keg vswzug
Possible decryption with key may: Hdism yayx wgwjtv kstswgn mnmx kcg tswxug
Possible decryption with key mbc: Hcesl yzux sgvftu krpsvcn inlt jyg psvtuf
Possible decryption with key mbj: Hcxsl yznx lgvytu krisvvn bnlm jrg isvmuf
Possible decryption with key mbw: Hcksl yzax ygvltu krvsvin onlz jeg vsvzuf
Possible decryption with key mby: Hcisl yzyx wgvjtu krtsvgn mnlx jcg tsvxuf
Possible decryption with key mcc: Hbesk yyux sguftt kqpsucn inkt iyg psutue
Possible decryption with key mci: Hbysk yyox mguztt kqjsuwn cnkn isg jsunue
Possible decryption with key mcj: Hbxsk yynx lguytt kqisuvn bnkm irg isumue
Possible decryption with key mcn: Hbtsk yyjx hguutt kqesurn xnki ing esuiue
Possible decryption with key mcw: Hbksk yyax ygultt kqvsuin onkz ieg vsuzue
Possible decryption with key mcy: Hbisk yyyx wgujtt kqtsugn mnkx icg tsuxue
Possible decryption with key mdc: Haesj yxux sgtfts kppstcn injt hyg psttud
Possible decryption with key mdh: Hazsj yxpx ngtats kpkstxn dnjo htg kstoud
Possible decryption with key mdj: Haxsj yxnx lgtyts kpistvn bnjm hrg istmud
Possible decryption with key mdq: Haqsj yxgx egtrts kpbston unjf hkg bstfud
Possible decryption with key mdt: Hansj yxdx bgtots kpystln rnjc hhg ystcud
Possible decryption with key mdw: Haksj yxax ygtlts kpvstin onjz heg vstzud
Possible decryption with key mdy: Haisj yxyx wgtjts kptstgn mnjx hcg tstxud
Possible decryption with key mec: Hzesi ywux sgsftr kopsscn init gyg psstuc
Possible decryption with key med: Hzdsi ywtx rgsetr koossbn hnis gxg osssuc
Possible decryption with key mei: Hzysi ywox mgsztr kojsswn cnin gsg jssnuc
Possible decryption with key mej: Hzxsi ywnx lgsytr koissvn bnim grg issmuc
Possible decryption with key mem: Hzusi ywkx igsvtr kofsssn ynij gog fssjuc
Possible decryption with key mew: Hzksi ywax ygsltr kovssin oniz geg vsszuc
Possible decryption with key mey: Hzisi ywyx wgsjtr kotssgn mnix gcg tssxuc
Possible decryption with key mfc: Hyesh yvux sgrftq knpsrcn inht fyg psrtub
Possible decryption with key mfj: Hyxsh yvnx lgrytq knisrvn bnhm frg isrmub
Possible decryption with key mfw: Hyksh yvax ygrltq knvsrin onhz feg vsrzub
Possible decryption with key mfy: Hyish yvyx wgrjtq kntsrgn mnhx fcg tsrxub
Possible decryption with key mgc: Hxesg yuux sgqftp kmpsqcn ingt eyg psqtua
Possible decryption with key mgj: Hxxsg yunx lgqytp kmisqvn bngm erg isqmua
Possible decryption with key mgw: Hxksg yuax ygqltp kmvsqin ongz eeg vsqzua
Possible decryption with key mgy: Hxisg yuyx wgqjtp kmtsqgn mngx ecg tsqxua
Possible decryption with key mha: Hwgsf ytwx ugphto klrspen knfv dag rspvuz
Possible decryption with key mhb: Hwfsf ytvx tgpgto klqspdn jnfu dzg qspuuz
Possible decryption with key mhc: Hwesf ytux sgpfto klpspcn inft dyg psptuz
Possible decryption with key mhd: Hwdsf yttx rgpeto klospbn hnfs dxg ospsuz
Possible decryption with key mhe: Hwcsf ytsx qgpdto klnspan gnfr dwg nspruz
Possible decryption with key mhf: Hwbsf ytrx pgpcto klmspzn fnfq dvg mspquz
Possible decryption with key mhg: Hwasf ytqx ogpbto kllspyn enfp dug lsppuz
Possible decryption with key mhh: Hwzsf ytpx ngpato klkspxn dnfo dtg kspouz
Possible decryption with key mhi: Hwysf ytox mgpzto kljspwn cnfn dsg jspnuz
Possible decryption with key mhj: Hwxsf ytnx lgpyto klispvn bnfm drg ispmuz
Possible decryption with key mhk: Hwwsf ytmx kgpxto klhspun anfl dqg hspluz
Possible decryption with key mhl: Hwvsf ytlx jgpwto klgsptn znfk dpg gspkuz
Possible decryption with key mhm: Hwusf ytkx igpvto klfspsn ynfj dog fspjuz
Possible decryption with key mhn: Hwtsf ytjx hgputo klesprn xnfi dng espiuz
Possible decryption with key mho: Hwssf ytix ggptto kldspqn wnfh dmg dsphuz
Possible decryption with key mhp: Hwrsf ythx fgpsto klcsppn vnfg dlg cspguz
Possible decryption with key mhq: Hwqsf ytgx egprto klbspon unff dkg bspfuz
Possible decryption with key mhr: Hwpsf ytfx dgpqto klaspnn tnfe djg aspeuz
Possible decryption with key mhs: Hwosf ytex cgppto klzspmn snfd dig zspduz
Possible decryption with key mht: Hwnsf ytdx bgpoto klyspln rnfc dhg yspcuz
Possible decryption with key mhu: Hwmsf ytcx agpnto klxspkn qnfb dgg xspbuz
Possible decryption with key mhv: Hwlsf ytbx zgpmto klwspjn pnfa dfg wspauz
Possible decryption with key mhw: Hwksf ytax ygplto klvspin onfz deg vspzuz
Possible decryption with key mhx: Hwjsf ytzx xgpkto klusphn nnfy ddg uspyuz
Possible decryption with key mhy: Hwisf ytyx wgpjto kltspgn mnfx dcg tspxuz
Possible decryption with key mhz: Hwhsf ytxx vgpito klsspfn lnfw dbg sspwuz
Possible decryption with key mic: Hvese ysux sgoftn kkpsocn inet cyg psotuy
Possible decryption with key mij: Hvxse ysnx lgoytn kkisovn bnem crg isomuy
Possible decryption with key miq: Hvqse ysgx egortn kkbsoon unef ckg bsofuy
Possible decryption with key miw: Hvkse ysax ygoltn kkvsoin onez ceg vsozuy
Possible decryption with key miy: Hvise ysyx wgojtn kktsogn mnex ccg tsoxuy
Possible decryption with key miz: Hvhse ysxx vgoitn kkssofn lnew cbg ssowuy
Possible decryption with key mjc: Huesd yrux sgnftm kjpsncn indt byg psntux
Possible decryption with key mjj: Huxsd yrnx lgnytm kjisnvn bndm brg isnmux
Possible decryption with key mjk: Huwsd yrmx kgnxtm kjhsnun andl bqg hsnlux
Possible decryption with key mjw: Huksd yrax ygnltm kjvsnin ondz beg vsnzux
Possible decryption with key mjy: Huisd yryx wgnjtm kjtsngn mndx bcg tsnxux
Possible decryption with key mkc: Htesc yqux sgmftl kipsmcn inct ayg psmtuw
Possible decryption with key mke: Htcsc yqsx qgmdtl kinsman gncr awg nsmruw
Possible decryption with key mkj: Htxsc yqnx lgmytl kiismvn bncm arg ismmuw
Possible decryption with key mks: Htosc yqex cgmptl kizsmmn sncd aig zsmduw
Possible decryption with key mkw: Htksc yqax ygmltl kivsmin oncz aeg vsmzuw
Possible decryption with key mky: Htisc yqyx wgmjtl kitsmgn mncx acg tsmxuw
Possible decryption with key mkz: Hthsc yqxx vgmitl kissmfn lncw abg ssmwuw
Possible decryption with key mlc: Hsesb ypux sglftk khpslcn inbt zyg psltuv
Possible decryption with key mlj: Hsxsb ypnx lglytk khislvn bnbm zrg islmuv
Possible decryption with key mlw: Hsksb ypax yglltk khvslin onbz zeg vslzuv
Possible decryption with key mly: Hsisb ypyx wgljtk khtslgn mnbx zcg tslxuv
Possible decryption with key mmc: Hresa youx sgkftj kgpskcn inat yyg psktuu
Possible decryption with key mmj: Hrxsa yonx lgkytj kgiskvn bnam yrg iskmuu
Possible decryption with key mmr: Hrpsa yofx dgkqtj kgasknn tnae yjg askeuu
Possible decryption with key mmw: Hrksa yoax ygkltj kgvskin onaz yeg vskzuu
Possible decryption with key mmy: Hrisa yoyx wgkjtj kgtskgn mnax ycg tskxuu
Possible decryption with key mnc: Hqesz ynux sgjfti kfpsjcn inzt xyg psjtut
Possible decryption with key mnj: Hqxsz ynnx lgjyti kfisjvn bnzm xrg isjmut
Possible decryption with key mnw: Hqksz ynax ygjlti kfvsjin onzz xeg vsjzut
Possible decryption with key mny: Hqisz ynyx wgjjti kftsjgn mnzx xcg tsjxut
Possible decryption with key moc: Hpesy ymux sgifth kepsicn inyt wyg psitus
Possible decryption with key mod: Hpdsy ymtx rgieth keosibn hnys wxg osisus
Possible decryption with key moi: Hpysy ymox mgizth kejsiwn cnyn wsg jsinus
Possible decryption with key moj: Hpxsy ymnx lgiyth keisivn bnym wrg isimus
Possible decryption with key mom: Hpusy ymkx igivth kefsisn ynyj wog fsijus
Possible decryption with key mop: Hprsy ymhx fgisth kecsipn vnyg wlg csigus
Possible decryption with key mor: Hppsy ymfx dgiqth keasinn tnye wjg asieus
Possible decryption with key mou: Hpmsy ymcx aginth kexsikn qnyb wgg xsibus
Possible decryption with key mow: Hpksy ymax ygilth kevsiin onyz weg vsizus
Possible decryption with key moy: Hpisy ymyx wgijth ketsign mnyx wcg tsixus
Possible decryption with key mpb: Hofsx ylvx tghgtg kdqshdn jnxu vzg qshuur
Possible decryption with key mpc: Hoesx ylux sghftg kdpshcn inxt vyg pshtur
Possible decryption with key mpj: Hoxsx ylnx lghytg kdishvn bnxm vrg ishmur
Possible decryption with key mpw: Hoksx ylax yghltg kdvshin onxz veg vshzur
Possible decryption with key mpy: Hoisx ylyx wghjtg kdtshgn mnxx vcg tshxur
Possible decryption with key mqc: Hnesw ykux sggftf kcpsgcn inwt uyg psgtuq
Possible decryption with key mqj: Hnxsw yknx lggytf kcisgvn bnwm urg isgmuq
Possible decryption with key mqw: Hnksw ykax yggltf kcvsgin onwz ueg vsgzuq
Possible decryption with key mqy: Hnisw ykyx wggjtf kctsggn mnwx ucg tsgxuq
Possible decryption with key mrc: Hmesv yjux sgffte kbpsfcn invt tyg psftup
Possible decryption with key mrj: Hmxsv yjnx lgfyte kbisfvn bnvm trg isfmup
Possible decryption with key mrm: Hmusv yjkx igfvte kbfsfsn ynvj tog fsfjup
Possible decryption with key mrw: Hmksv yjax ygflte kbvsfin onvz teg vsfzup
Possible decryption with key mry: Hmisv yjyx wgfjte kbtsfgn mnvx tcg tsfxup
Possible decryption with key msc: Hlesu yiux sgeftd kapsecn inut syg psetuo
Possible decryption with key mse: Hlcsu yisx qgedtd kansean gnur swg nseruo
Possible decryption with key msj: Hlxsu yinx lgeytd kaisevn bnum srg isemuo
Possible decryption with key msw: Hlksu yiax ygeltd kavsein onuz seg vsezuo
Possible decryption with key msy: Hlisu yiyx wgejtd katsegn mnux scg tsexuo
Possible decryption with key mtc: Hkest yhux sgdftc kzpsdcn intt ryg psdtun
Possible decryption with key mth: Hkzst yhpx ngdatc kzksdxn dnto rtg ksdoun
Possible decryption with key mtj: Hkxst yhnx lgdytc kzisdvn bntm rrg isdmun
Possible decryption with key mtw: Hkkst yhax ygdltc kzvsdin ontz reg vsdzun
Possible decryption with key mty: Hkist yhyx wgdjtc kztsdgn mntx rcg tsdxun
Possible decryption with key muc: Hjess ygux sgcftb kypsccn inst qyg psctum
Possible decryption with key muj: Hjxss ygnx lgcytb kyiscvn bnsm qrg iscmum
Possible decryption with key muw: Hjkss ygax ygcltb kyvscin onsz qeg vsczum
Possible decryption with key muy: Hjiss ygyx wgcjtb kytscgn mnsx qcg tscxum
Possible decryption with key mvc: Hiesr yfux sgbfta kxpsbcn inrt pyg psbtul
Possible decryption with key mvj: Hixsr yfnx lgbyta kxisbvn bnrm prg isbmul
Possible decryption with key mvo: Hissr yfix ggbtta kxdsbqn wnrh pmg dsbhul
Possible decryption with key mvt: Hinsr yfdx bgbota kxysbln rnrc phg ysbcul
Possible decryption with key mvw: Hiksr yfax ygblta kxvsbin onrz peg vsbzul
Possible decryption with key mvy: Hiisr yfyx wgbjta kxtsbgn mnrx pcg tsbxul
Possible decryption with key mwc: Hhesq yeux sgaftz kwpsacn inqt oyg psatuk
Possible decryption with key mwj: Hhxsq yenx lgaytz kwisavn bnqm org isamuk
Possible decryption with key mwv: Hhlsq yebx zgamtz kwwsajn pnqa ofg wsaauk
Possible decryption with key mww: Hhksq yeax ygaltz kwvsain onqz oeg vsazuk
Possible decryption with key mwy: Hhisq yeyx wgajtz kwtsagn mnqx ocg tsaxuk
Possible decryption with key mxc: Hgesp ydux sgzfty kvpszcn inpt nyg psztuj
Possible decryption with key mxj: Hgxsp ydnx lgzyty kviszvn bnpm nrg iszmuj
Possible decryption with key mxw: Hgksp ydax ygzlty kvvszin onpz neg vszzuj
Possible decryption with key mxy: Hgisp ydyx wgzjty kvtszgn mnpx ncg tszxuj
Possible decryption with key myc: Hfeso ycux sgyftx kupsycn inot myg psytui
Possible decryption with key myj: Hfxso ycnx lgyytx kuisyvn bnom mrg isymui
Possible decryption with key myq: Hfqso ycgx egyrtx kubsyon unof mkg bsyfui
Possible decryption with key myw: Hfkso ycax ygyltx kuvsyin onoz meg vsyzui
Possible decryption with key myy: Hfiso ycyx wgyjtx kutsygn mnox mcg tsyxui
Possible decryption with key mzc: Heesn ybux sgxftw ktpsxcn innt lyg psxtuh
Possible decryption with key mzd: Hedsn ybtx rgxetw ktosxbn hnns lxg osxsuh
Possible decryption with key mzj: Hexsn ybnx lgxytw ktisxvn bnnm lrg isxmuh
Possible decryption with key mzw: Heksn ybax ygxltw ktvsxin onnz leg vsxzuh
Possible decryption with key mzy: Heisn ybyx wgxjtw kttsxgn mnnx lcg tsxxuh
Possible decryption with key nag: Gdarm xaqw ofwbsv jslrwym emmp kuf lrwptg
Possible decryption with key nam: Gdurm xakw ifwvsv jsfrwsm ymmj kof frwjtg
Possible decryption with key naz: Gdhrm xaxw vfwisv jssrwfm lmmw kbf srwwtg
Possible decryption with key nbg: Gcarl xzqw ofvbsu jrlrvym emlp juf lrvptf
Possible decryption with key nbm: Gcurl xzkw ifvvsu jrfrvsm ymlj jof frvjtf
Possible decryption with key nbz: Gchrl xzxw vfvisu jrsrvfm lmlw jbf srvwtf
Possible decryption with key ncg: Gbark xyqw ofubst jqlruym emkp iuf lrupte
Possible decryption with key nci: Gbyrk xyow mfuzst jqjruwm cmkn isf jrunte
Possible decryption with key ncm: Gburk xykw ifuvst jqfrusm ymkj iof frujte
Possible decryption with key ncn: Gbtrk xyjw hfuust jqerurm xmki inf eruite
Possible decryption with key ncz: Gbhrk xyxw vfuist jqsrufm lmkw ibf sruwte
Possible decryption with key ndg: Gaarj xxqw oftbss jplrtym emjp huf lrtptd
Possible decryption with key ndh: Gazrj xxpw nftass jpkrtxm dmjo htf krtotd
Possible decryption with key ndm: Gaurj xxkw iftvss jpfrtsm ymjj hof frtjtd
Possible decryption with key ndq: Gaqrj xxgw eftrss jpbrtom umjf hkf brtftd
Possible decryption with key ndt: Ganrj xxdw bftoss jpyrtlm rmjc hhf yrtctd
Possible decryption with key ndz: Gahrj xxxw vftiss jpsrtfm lmjw hbf srtwtd
Possible decryption with key ned: Gzdri xwtw rfsesr joorsbm hmis gxf orsstc
Possible decryption with key neg: Gzari xwqw ofsbsr jolrsym emip guf lrsptc
Possible decryption with key nei: Gzyri xwow mfszsr jojrswm cmin gsf jrsntc
Possible decryption with key nem: Gzuri xwkw ifsvsr jofrssm ymij gof frsjtc
Possible decryption with key nez: Gzhri xwxw vfsisr josrsfm lmiw gbf srswtc
Possible decryption with key nfg: Gyarh xvqw ofrbsq jnlrrym emhp fuf lrrptb
Possible decryption with key nfm: Gyurh xvkw ifrvsq jnfrrsm ymhj fof frrjtb
Possible decryption with key nfz: Gyhrh xvxw vfrisq jnsrrfm lmhw fbf srrwtb
Possible decryption with key ngg: Gxarg xuqw ofqbsp jmlrqym emgp euf lrqpta
Possible decryption with key ngm: Gxurg xukw ifqvsp jmfrqsm ymgj eof frqjta
Possible decryption with key ngz: Gxhrg xuxw vfqisp jmsrqfm lmgw ebf srqwta
Possible decryption with key nhg: Gwarf xtqw ofpbso jllrpym emfp duf lrpptz
Possible decryption with key nhi: Gwyrf xtow mfpzso jljrpwm cmfn dsf jrpntz
Possible decryption with key nhm: Gwurf xtkw ifpvso jlfrpsm ymfj dof frpjtz
Possible decryption with key nhz: Gwhrf xtxw vfpiso jlsrpfm lmfw dbf srpwtz
Possible decryption with key nic: Gvere xsuw sfofsn jkprocm imet cyf protty
Possible decryption with key nig: Gvare xsqw ofobsn jklroym emep cuf lropty
Possible decryption with key nim: Gvure xskw ifovsn jkfrosm ymej cof frojty
Possible decryption with key niq: Gvqre xsgw eforsn jkbroom umef ckf brofty
Possible decryption with key niz: Gvhre xsxw vfoisn jksrofm lmew cbf srowty
Possible decryption with key njg: Guard xrqw ofnbsm jjlrnym emdp buf lrnptx
Possible decryption with key njm: Guurd xrkw ifnvsm jjfrnsm ymdj bof frnjtx
Possible decryption with key njz: Guhrd xrxw vfnism jjsrnfm lmdw bbf srnwtx
Possible decryption with key nke: Gtcrc xqsw qfmdsl jinrmam gmcr awf nrmrtw
Possible decryption with key nkg: Gtarc xqqw ofmbsl jilrmym emcp auf lrmptw
Possible decryption with key nkm: Gturc xqkw ifmvsl jifrmsm ymcj aof frmjtw
Possible decryption with key nks: Gtorc xqew cfmpsl jizrmmm smcd aif zrmdtw
Possible decryption with key nkz: Gthrc xqxw vfmisl jisrmfm lmcw abf srmwtw
Possible decryption with key nlg: Gsarb xpqw oflbsk jhlrlym embp zuf lrlptv
Possible decryption with key nlm: Gsurb xpkw iflvsk jhfrlsm ymbj zof frljtv
Possible decryption with key nlz: Gshrb xpxw vflisk jhsrlfm lmbw zbf srlwtv
Possible decryption with key nmg: Grara xoqw ofkbsj jglrkym emap yuf lrkptu
Possible decryption with key nmm: Grura xokw ifkvsj jgfrksm ymaj yof frkjtu
Possible decryption with key nmr: Grpra xofw dfkqsj jgarknm tmae yjf arketu
Possible decryption with key nmz: Grhra xoxw vfkisj jgsrkfm lmaw ybf srkwtu
Possible decryption with key nng: Gqarz xnqw ofjbsi jflrjym emzp xuf lrjptt
Possible decryption with key nnm: Gqurz xnkw ifjvsi jffrjsm ymzj xof frjjtt
Possible decryption with key nnz: Gqhrz xnxw vfjisi jfsrjfm lmzw xbf srjwtt
Possible decryption with key nod: Gpdry xmtw rfiesh jeoribm hmys wxf orists
Possible decryption with key nog: Gpary xmqw ofibsh jelriym emyp wuf lripts
Possible decryption with key noi: Gpyry xmow mfizsh jejriwm cmyn wsf jrints
Possible decryption with key nom: Gpury xmkw ifivsh jefrism ymyj wof frijts
Possible decryption with key nop: Gprry xmhw ffissh jecripm vmyg wlf crigts
Possible decryption with key nor: Gppry xmfw dfiqsh jearinm tmye wjf ariets
Possible decryption with key nou: Gpmry xmcw afinsh jexrikm qmyb wgf xribts
Possible decryption with key noz: Gphry xmxw vfiish jesrifm lmyw wbf sriwts
Possible decryption with key npb: Gofrx xlvw tfhgsg jdqrhdm jmxu vzf qrhutr
Possible decryption with key npg: Goarx xlqw ofhbsg jdlrhym emxp vuf lrhptr
Possible decryption with key npm: Gourx xlkw ifhvsg jdfrhsm ymxj vof frhjtr
Possible decryption with key npz: Gohrx xlxw vfhisg jdsrhfm lmxw vbf srhwtr
Possible decryption with key nqg: Gnarw xkqw ofgbsf jclrgym emwp uuf lrgptq
Possible decryption with key nqm: Gnurw xkkw ifgvsf jcfrgsm ymwj uof frgjtq
Possible decryption with key nqz: Gnhrw xkxw vfgisf jcsrgfm lmww ubf srgwtq
Possible decryption with key nrg: Gmarv xjqw offbse jblrfym emvp tuf lrfptp
Possible decryption with key nrm: Gmurv xjkw iffvse jbfrfsm ymvj tof frfjtp
Possible decryption with key nrz: Gmhrv xjxw vffise jbsrffm lmvw tbf srfwtp
Possible decryption with key nsa: Glgru xiww ufehsd jarreem kmuv saf rrevto
Possible decryption with key nsb: Glfru xivw tfegsd jaqredm jmuu szf qreuto
Possible decryption with key nsc: Gleru xiuw sfefsd japrecm imut syf pretto
Possible decryption with key nsd: Gldru xitw rfeesd jaorebm hmus sxf oresto
Possible decryption with key nse: Glcru xisw qfedsd janream gmur swf nrerto
Possible decryption with key nsf: Glbru xirw pfecsd jamrezm fmuq svf mreqto
Possible decryption with key nsg: Glaru xiqw ofebsd jalreym emup suf lrepto
Possible decryption with key nsh: Glzru xipw nfeasd jakrexm dmuo stf kreoto
Possible decryption with key nsi: Glyru xiow mfezsd jajrewm cmun ssf jrento
Possible decryption with key nsj: Glxru xinw lfeysd jairevm bmum srf iremto
Possible decryption with key nsk: Glwru ximw kfexsd jahreum amul sqf hrelto
Possible decryption with key nsl: Glvru xilw jfewsd jagretm zmuk spf grekto
Possible decryption with key nsm: Gluru xikw ifevsd jafresm ymuj sof frejto
Possible decryption with key nsn: Gltru xijw hfeusd jaererm xmui snf ereito
Possible decryption with key nso: Glsru xiiw gfetsd jadreqm wmuh smf drehto
Possible decryption with key nsp: Glrru xihw ffessd jacrepm vmug slf cregto
Possible decryption with key nsq: Glqru xigw efersd jabreom umuf skf brefto
Possible decryption with key nsr: Glpru xifw dfeqsd jaarenm tmue sjf areeto
Possible decryption with key nss: Gloru xiew cfepsd jazremm smud sif zredto
Possible decryption with key nst: Glnru xidw bfeosd jayrelm rmuc shf yrecto
Possible decryption with key nsu: Glmru xicw afensd jaxrekm qmub sgf xrebto
Possible decryption with key nsv: Gllru xibw zfemsd jawrejm pmua sff wreato
Possible decryption with key nsw: Glkru xiaw yfelsd javreim omuz sef vrezto
Possible decryption with key nsx: Gljru xizw xfeksd jaurehm nmuy sdf ureyto
Possible decryption with key nsy: Gliru xiyw wfejsd jatregm mmux scf trexto
Possible decryption with key nsz: Glhru xixw vfeisd jasrefm lmuw sbf srewto
Possible decryption with key ntg: Gkart xhqw ofdbsc jzlrdym emtp ruf lrdptn
Possible decryption with key nth: Gkzrt xhpw nfdasc jzkrdxm dmto rtf krdotn
Possible decryption with key ntm: Gkurt xhkw ifdvsc jzfrdsm ymtj rof frdjtn
Possible decryption with key ntz: Gkhrt xhxw vfdisc jzsrdfm lmtw rbf srdwtn
Possible decryption with key nug: Gjars xgqw ofcbsb jylrcym emsp quf lrcptm
Possible decryption with key num: Gjurs xgkw ifcvsb jyfrcsm ymsj qof frcjtm
Possible decryption with key nuz: Gjhrs xgxw vfcisb jysrcfm lmsw qbf srcwtm
Possible decryption with key nvg: Giarr xfqw ofbbsa jxlrbym emrp puf lrbptl
Possible decryption with key nvm: Giurr xfkw ifbvsa jxfrbsm ymrj pof frbjtl
Possible decryption with key nvo: Gisrr xfiw gfbtsa jxdrbqm wmrh pmf drbhtl
Possible decryption with key nvt: Ginrr xfdw bfbosa jxyrblm rmrc phf yrbctl
Possible decryption with key nvz: Gihrr xfxw vfbisa jxsrbfm lmrw pbf srbwtl
Possible decryption with key nwg: Gharq xeqw ofabsz jwlraym emqp ouf lraptk
Possible decryption with key nwm: Ghurq xekw ifavsz jwfrasm ymqj oof frajtk
Possible decryption with key nwv: Ghlrq xebw zfamsz jwwrajm pmqa off wraatk
Possible decryption with key nwz: Ghhrq xexw vfaisz jwsrafm lmqw obf srawtk
Possible decryption with key nxg: Ggarp xdqw ofzbsy jvlrzym empp nuf lrzptj
Possible decryption with key nxm: Ggurp xdkw ifzvsy jvfrzsm ympj nof frzjtj
Possible decryption with key nxz: Gghrp xdxw vfzisy jvsrzfm lmpw nbf srzwtj
Possible decryption with key nyg: Gfaro xcqw ofybsx julryym emop muf lrypti
Possible decryption with key nym: Gfuro xckw ifyvsx jufrysm ymoj mof fryjti
Possible decryption with key nyq: Gfqro xcgw efyrsx jubryom umof mkf bryfti
Possible decryption with key nyz: Gfhro xcxw vfyisx jusryfm lmow mbf srywti
Possible decryption with key nzd: Gedrn xbtw rfxesw jtorxbm hmns lxf orxsth
Possible decryption with key nzg: Gearn xbqw ofxbsw jtlrxym emnp luf lrxpth
Possible decryption with key nzm: Geurn xbkw ifxvsw jtfrxsm ymnj lof frxjth
Possible decryption with key nzz: Gehrn xbxw vfxisw jtsrxfm lmnw lbf srxwth
Possible decryption with key oaa: Fdgqm wawv uewhrv isrqwel klmv kae rqwvsg
Possible decryption with key oab: Fdfqm wavv tewgrv isqqwdl jlmu kze qqwusg
Possible decryption with key oac: Fdeqm wauv sewfrv ispqwcl ilmt kye pqwtsg
Possible decryption with key oad: Fddqm watv rewerv isoqwbl hlms kxe oqwssg
Possible decryption with key oae: Fdcqm wasv qewdrv isnqwal glmr kwe nqwrsg
Possible decryption with key oaf: Fdbqm warv pewcrv ismqwzl flmq kve mqwqsg
Possible decryption with key oag: Fdaqm waqv oewbrv islqwyl elmp kue lqwpsg
Possible decryption with key oah: Fdzqm wapv newarv iskqwxl dlmo kte kqwosg
Possible decryption with key oai: Fdyqm waov mewzrv isjqwwl clmn kse jqwnsg
Possible decryption with key oaj: Fdxqm wanv lewyrv isiqwvl blmm kre iqwmsg
Possible decryption with key oak: Fdwqm wamv kewxrv ishqwul alml kqe hqwlsg
Possible decryption with key oal: Fdvqm walv jewwrv isgqwtl zlmk kpe gqwksg
Possible decryption with key oam: Fduqm wakv iewvrv isfqwsl ylmj koe fqwjsg
Possible decryption with key oan: Fdtqm wajv hewurv iseqwrl xlmi kne eqwisg
Possible decryption with key oao: Fdsqm waiv gewtrv isdqwql wlmh kme dqwhsg
Possible decryption with key oap: Fdrqm wahv fewsrv iscqwpl vlmg kle cqwgsg
Possible decryption with key oaq: Fdqqm wagv eewrrv isbqwol ulmf kke bqwfsg
Possible decryption with key oar: Fdpqm wafv dewqrv isaqwnl tlme kje aqwesg
Possible decryption with key oas: Fdoqm waev cewprv iszqwml slmd kie zqwdsg
Possible decryption with key oat: Fdnqm wadv beworv isyqwll rlmc khe yqwcsg
Possible decryption with key oau: Fdmqm wacv aewnrv isxqwkl qlmb kge xqwbsg
Possible decryption with key oav: Fdlqm wabv zewmrv iswqwjl plma kfe wqwasg
Possible decryption with key oaw: Fdkqm waav yewlrv isvqwil olmz kee vqwzsg
Possible decryption with key oax: Fdjqm wazv xewkrv isuqwhl nlmy kde uqwysg
Possible decryption with key oay: Fdiqm wayv wewjrv istqwgl mlmx kce tqwxsg
Possible decryption with key oaz: Fdhqm waxv vewirv issqwfl llmw kbe sqwwsg
Possible decryption with key obn: Fctql wzjv hevuru ireqvrl xlli jne eqvisf
Possible decryption with key oci: Fbyqk wyov meuzrt iqjquwl clkn ise jqunse
Possible decryption with key ocn: Fbtqk wyjv heuurt iqequrl xlki ine equise
Possible decryption with key odh: Fazqj wxpv netars ipkqtxl dljo hte kqtosd
Possible decryption with key odn: Fatqj wxjv heturs ipeqtrl xlji hne eqtisd
Possible decryption with key odq: Faqqj wxgv eetrrs ipbqtol uljf hke bqtfsd
Possible decryption with key odt: Fanqj wxdv betors ipyqtll rljc hhe yqtcsd
Possible decryption with key oed: Fzdqi wwtv reserr iooqsbl hlis gxe oqsssc
Possible decryption with key oei: Fzyqi wwov meszrr iojqswl clin gse jqsnsc
Possible decryption with key oem: Fzuqi wwkv iesvrr iofqssl ylij goe fqsjsc
Possible decryption with key oen: Fztqi wwjv hesurr ioeqsrl xlii gne eqsisc
Possible decryption with key ofa: Fygqh wvwv uerhrq inrqrel klhv fae rqrvsb
Possible decryption with key ofb: Fyfqh wvvv tergrq inqqrdl jlhu fze qqrusb
Possible decryption with key ofc: Fyeqh wvuv serfrq inpqrcl ilht fye pqrtsb
Possible decryption with key ofd: Fydqh wvtv rererq inoqrbl hlhs fxe oqrssb
Possible decryption with key ofe: Fycqh wvsv qerdrq innqral glhr fwe nqrrsb
Possible decryption with key off: Fybqh wvrv percrq inmqrzl flhq fve mqrqsb
Possible decryption with key ofg: Fyaqh wvqv oerbrq inlqryl elhp fue lqrpsb
Possible decryption with key ofh: Fyzqh wvpv nerarq inkqrxl dlho fte kqrosb
Possible decryption with key ofi: Fyyqh wvov merzrq injqrwl clhn fse jqrnsb
Possible decryption with key ofj: Fyxqh wvnv leryrq iniqrvl blhm fre iqrmsb
Possible decryption with key ofk: Fywqh wvmv kerxrq inhqrul alhl fqe hqrlsb
Possible decryption with key ofl: Fyvqh wvlv jerwrq ingqrtl zlhk fpe gqrksb
Possible decryption with key ofm: Fyuqh wvkv iervrq infqrsl ylhj foe fqrjsb
Possible decryption with key ofn: Fytqh wvjv herurq ineqrrl xlhi fne eqrisb
Possible decryption with key ofo: Fysqh wviv gertrq indqrql wlhh fme dqrhsb
Possible decryption with key ofp: Fyrqh wvhv fersrq incqrpl vlhg fle cqrgsb
Possible decryption with key ofq: Fyqqh wvgv eerrrq inbqrol ulhf fke bqrfsb
Possible decryption with key ofr: Fypqh wvfv derqrq inaqrnl tlhe fje aqresb
Possible decryption with key ofs: Fyoqh wvev cerprq inzqrml slhd fie zqrdsb
Possible decryption with key oft: Fynqh wvdv berorq inyqrll rlhc fhe yqrcsb
Possible decryption with key ofu: Fymqh wvcv aernrq inxqrkl qlhb fge xqrbsb
Possible decryption with key ofv: Fylqh wvbv zermrq inwqrjl plha ffe wqrasb
Possible decryption with key ofw: Fykqh wvav yerlrq invqril olhz fee vqrzsb
Possible decryption with key ofx: Fyjqh wvzv xerkrq inuqrhl nlhy fde uqrysb
Possible decryption with key ofy: Fyiqh wvyv werjrq intqrgl mlhx fce tqrxsb
Possible decryption with key ofz: Fyhqh wvxv verirq insqrfl llhw fbe sqrwsb
Possible decryption with key ogn: Fxtqg wujv hequrp imeqqrl xlgi ene eqqisa
Possible decryption with key ohi: Fwyqf wtov mepzro iljqpwl clfn dse jqpnsz
Possible decryption with key ohn: Fwtqf wtjv hepuro ileqprl xlfi dne eqpisz
Possible decryption with key oic: Fveqe wsuv seofrn ikpqocl ilet cye pqotsy
Possible decryption with key oin: Fvtqe wsjv heourn ikeqorl xlei cne eqoisy
Possible decryption with key oiq: Fvqqe wsgv eeorrn ikbqool ulef cke bqofsy
Possible decryption with key oiz: Fvhqe wsxv veoirn iksqofl llew cbe sqowsy
Possible decryption with key ojn: Futqd wrjv henurm ijeqnrl xldi bne eqnisx
Possible decryption with key oke: Ftcqc wqsv qemdrl iinqmal glcr awe nqmrsw
Possible decryption with key okn: Fttqc wqjv hemurl iieqmrl xlci ane eqmisw
Possible decryption with key oks: Ftoqc wqev cemprl iizqmml slcd aie zqmdsw
Possible decryption with key okz: Fthqc wqxv vemirl iisqmfl llcw abe sqmwsw
Possible decryption with key oln: Fstqb wpjv helurk iheqlrl xlbi zne eqlisv
Possible decryption with key omn: Frtqa wojv hekurj igeqkrl xlai yne eqkisu
Possible decryption with key omr: Frpqa wofv dekqrj igaqknl tlae yje aqkesu
Possible decryption with key onn: Fqtqz wnjv hejuri ifeqjrl xlzi xne eqjist
Possible decryption with key ood: Fpdqy wmtv reierh ieoqibl hlys wxe oqisss
Possible decryption with key ooi: Fpyqy wmov meizrh iejqiwl clyn wse jqinss
Possible decryption with key oom: Fpuqy wmkv ieivrh iefqisl ylyj woe fqijss
Possible decryption with key oon: Fptqy wmjv heiurh ieeqirl xlyi wne eqiiss
Possible decryption with key oop: Fprqy wmhv feisrh iecqipl vlyg wle cqigss
Possible decryption with key oor: Fppqy wmfv deiqrh ieaqinl tlye wje aqiess
Possible decryption with key oou: Fpmqy wmcv aeinrh iexqikl qlyb wge xqibss
Possible decryption with key opb: Fofqx wlvv tehgrg idqqhdl jlxu vze qqhusr
Possible decryption with key opn: Fotqx wljv hehurg ideqhrl xlxi vne eqhisr
Possible decryption with key oqn: Fntqw wkjv hegurf iceqgrl xlwi une eqgisq
Possible decryption with key orm: Fmuqv wjkv iefvre ibfqfsl ylvj toe fqfjsp
Possible decryption with key orn: Fmtqv wjjv hefure ibeqfrl xlvi tne eqfisp
Possible decryption with key ort: Fmnqv wjdv before ibyqfll rlvc the yqfcsp
Possible decryption with key ose: Flcqu wisv qeedrd ianqeal glur swe nqerso
Possible decryption with key osj: Flxqu winv leeyrd iaiqevl blum sre iqemso
Possible decryption with key osn: Fltqu wijv heeurd iaeqerl xlui sne eqeiso
Possible decryption with key oth: Fkzqt whpv nedarc izkqdxl dlto rte kqdosn
Possible decryption with key otn: Fktqt whjv hedurc izeqdrl xlti rne eqdisn
Possible decryption with key oun: Fjtqs wgjv hecurb iyeqcrl xlsi qne eqcism
Possible decryption with key ovn: Fitqr wfjv hebura ixeqbrl xlri pne eqbisl
Possible decryption with key ovo: Fisqr wfiv gebtra ixdqbql wlrh pme dqbhsl
Possible decryption with key ovt: Finqr wfdv bebora ixyqbll rlrc phe yqbcsl
Possible decryption with key own: Fhtqq wejv heaurz iweqarl xlqi one eqaisk
Possible decryption with key owv: Fhlqq webv zeamrz iwwqajl plqa ofe wqaask
Possible decryption with key oxn: Fgtqp wdjv hezury iveqzrl xlpi nne eqzisj
Possible decryption with key oyn: Fftqo wcjv heyurx iueqyrl xloi mne eqyisi
Possible decryption with key oyq: Ffqqo wcgv eeyrrx iubqyol ulof mke bqyfsi
Possible decryption with key ozd: Fedqn wbtv rexerw itoqxbl hlns lxe oqxssh
Possible decryption with key ozn: Fetqn wbjv hexurw iteqxrl xlni lne eqxish
Possible decryption with key pci: Ebypk vyou mduzqt hqjpuwk ckkn isd jpunre
Possible decryption with key pcn: Ebtpk vyju hduuqt hqepurk xkki ind epuire
Possible decryption with key pdh: Eazpj vxpu ndtaqs hpkptxk dkjo htd kptord
Possible decryption with key pdq: Eaqpj vxgu edtrqs hpbptok ukjf hkd bptfrd
Possible decryption with key pdt: Eanpj vxdu bdtoqs hpyptlk rkjc hhd yptcrd
Possible decryption with key ped: Ezdpi vwtu rdseqr hoopsbk hkis gxd opssrc
Possible decryption with key pei: Ezypi vwou mdszqr hojpswk ckin gsd jpsnrc
Possible decryption with key pem: Ezupi vwku idsvqr hofpssk ykij god fpsjrc
Possible decryption with key phi: Ewypf vtou mdpzqo hljppwk ckfn dsd jppnrz
Possible decryption with key pic: Evepe vsuu sdofqn hkppock iket cyd ppotry
Possible decryption with key piq: Evqpe vsgu edorqn hkbpook ukef ckd bpofry
Possible decryption with key piz: Evhpe vsxu vdoiqn hkspofk lkew cbd spowry
Possible decryption with key pke: Etcpc vqsu qdmdql hinpmak gkcr awd npmrrw
Possible decryption with key pkn: Ettpc vqju hdmuql hiepmrk xkci and epmirw
Possible decryption with key pks: Etopc vqeu cdmpql hizpmmk skcd aid zpmdrw
Possible decryption with key pkz: Ethpc vqxu vdmiql hispmfk lkcw abd spmwrw
Possible decryption with key pmr: Erppa vofu ddkqqj hgapknk tkae yjd apkeru
Possible decryption with key pod: Epdpy vmtu rdieqh heopibk hkys wxd opisrs
Possible decryption with key poi: Epypy vmou mdizqh hejpiwk ckyn wsd jpinrs
Possible decryption with key pom: Epupy vmku idivqh hefpisk ykyj wod fpijrs
Possible decryption with key pop: Eprpy vmhu fdisqh hecpipk vkyg wld cpigrs
Possible decryption with key por: Epppy vmfu ddiqqh heapink tkye wjd apiers
Possible decryption with key pou: Epmpy vmcu adinqh hexpikk qkyb wgd xpibrs
Possible decryption with key ppb: Eofpx vlvu tdhgqg hdqphdk jkxu vzd qphurr
Possible decryption with key prm: Emupv vjku idfvqe hbfpfsk ykvj tod fpfjrp
Possible decryption with key pse: Elcpu visu qdedqd hanpeak gkur swd nperro
Possible decryption with key psj: Elxpu vinu ldeyqd haipevk bkum srd ipemro
Possible decryption with key pth: Ekzpt vhpu nddaqc hzkpdxk dkto rtd kpdorn
Possible decryption with key pvo: Eispr vfiu gdbtqa hxdpbqk wkrh pmd dpbhrl
Possible decryption with key pvt: Einpr vfdu bdboqa hxypblk rkrc phd ypbcrl
Possible decryption with key pwv: Ehlpq vebu zdamqz hwwpajk pkqa ofd wpaark
Possible decryption with key pyq: Efqpo vcgu edyrqx hubpyok ukof mkd bpyfri
Possible decryption with key pzd: Eedpn vbtu rdxeqw htopxbk hkns lxd opxsrh
Possible decryption with key qan: Ddtom uajt hcwupv gseowrj xjmi knc eowiqg
Possible decryption with key qay: Ddiom uayt wcwjpv gstowgj mjmx kcc towxqg
Possible decryption with key qbn: Dctol uzjt hcvupu greovrj xjli jnc eoviqf
Possible decryption with key qby: Dciol uzyt wcvjpu grtovgj mjlx jcc tovxqf
Possible decryption with key qci: Dbyok uyot mcuzpt gqjouwj cjkn isc jounqe
Possible decryption with key qcn: Dbtok uyjt hcuupt gqeourj xjki inc eouiqe
Possible decryption with key qcy: Dbiok uyyt wcujpt gqtougj mjkx icc touxqe
Possible decryption with key qdh: Dazoj uxpt nctaps gpkotxj djjo htc kotoqd
Possible decryption with key qdn: Datoj uxjt hctups gpeotrj xjji hnc eotiqd
Possible decryption with key qdq: Daqoj uxgt ectrps gpbotoj ujjf hkc botfqd
Possible decryption with key qdt: Danoj uxdt bctops gpyotlj rjjc hhc yotcqd
Possible decryption with key qdy: Daioj uxyt wctjps gptotgj mjjx hcc totxqd
Possible decryption with key qed: Dzdoi uwtt rcsepr gooosbj hjis gxc oossqc
Possible decryption with key qei: Dzyoi uwot mcszpr gojoswj cjin gsc josnqc
Possible decryption with key qem: Dzuoi uwkt icsvpr gofossj yjij goc fosjqc
Possible decryption with key qen: Dztoi uwjt hcsupr goeosrj xjii gnc eosiqc
Possible decryption with key qey: Dzioi uwyt wcsjpr gotosgj mjix gcc tosxqc
Possible decryption with key qfn: Dytoh uvjt hcrupq gneorrj xjhi fnc eoriqb
Possible decryption with key qfy: Dyioh uvyt wcrjpq gntorgj mjhx fcc torxqb
Possible decryption with key qgn: Dxtog uujt hcqupp gmeoqrj xjgi enc eoqiqa
Possible decryption with key qgy: Dxiog uuyt wcqjpp gmtoqgj mjgx ecc toqxqa
Possible decryption with key qha: Dwgof utwt ucphpo glropej kjfv dac ropvqz
Possible decryption with key qhb: Dwfof utvt tcpgpo glqopdj jjfu dzc qopuqz
Possible decryption with key qhc: Dweof utut scpfpo glpopcj ijft dyc poptqz
Possible decryption with key qhd: Dwdof uttt rcpepo gloopbj hjfs dxc oopsqz
Possible decryption with key qhe: Dwcof utst qcpdpo glnopaj gjfr dwc noprqz
Possible decryption with key qhf: Dwbof utrt pcpcpo glmopzj fjfq dvc mopqqz
Possible decryption with key qhg: Dwaof utqt ocpbpo gllopyj ejfp duc loppqz
Possible decryption with key qhh: Dwzof utpt ncpapo glkopxj djfo dtc kopoqz
Possible decryption with key qhi: Dwyof utot mcpzpo gljopwj cjfn dsc jopnqz
Possible decryption with key qhj: Dwxof utnt lcpypo gliopvj bjfm drc iopmqz
Possible decryption with key qhk: Dwwof utmt kcpxpo glhopuj ajfl dqc hoplqz
Possible decryption with key qhl: Dwvof utlt jcpwpo glgoptj zjfk dpc gopkqz
Possible decryption with key qhm: Dwuof utkt icpvpo glfopsj yjfj doc fopjqz
Possible decryption with key qhn: Dwtof utjt hcpupo gleoprj xjfi dnc eopiqz
Possible decryption with key qho: Dwsof utit gcptpo gldopqj wjfh dmc dophqz
Possible decryption with key qhp: Dwrof utht fcpspo glcoppj vjfg dlc copgqz
Possible decryption with key qhq: Dwqof utgt ecprpo glbopoj ujff dkc bopfqz
Possible decryption with key qhr: Dwpof utft dcpqpo glaopnj tjfe djc aopeqz
Possible decryption with key qhs: Dwoof utet ccpppo glzopmj sjfd dic zopdqz
Possible decryption with key qht: Dwnof utdt bcpopo glyoplj rjfc dhc yopcqz
Possible decryption with key qhu: Dwmof utct acpnpo glxopkj qjfb dgc xopbqz
Possible decryption with key qhv: Dwlof utbt zcpmpo glwopjj pjfa dfc wopaqz
Possible decryption with key qhw: Dwkof utat ycplpo glvopij ojfz dec vopzqz
Possible decryption with key qhx: Dwjof utzt xcpkpo gluophj njfy ddc uopyqz
Possible decryption with key qhy: Dwiof utyt wcpjpo gltopgj mjfx dcc topxqz
Possible decryption with key qhz: Dwhof utxt vcpipo glsopfj ljfw dbc sopwqz
Possible decryption with key qic: Dveoe usut scofpn gkpoocj ijet cyc pootqy
Possible decryption with key qin: Dvtoe usjt hcoupn gkeoorj xjei cnc eooiqy
Possible decryption with key qiq: Dvqoe usgt ecorpn gkboooj ujef ckc boofqy
Possible decryption with key qiy: Dvioe usyt wcojpn gktoogj mjex ccc tooxqy
Possible decryption with key qiz: Dvhoe usxt vcoipn gksoofj ljew cbc soowqy
Possible decryption with key qjn: Dutod urjt hcnupm gjeonrj xjdi bnc eoniqx
Possible decryption with key qjy: Duiod uryt wcnjpm gjtongj mjdx bcc tonxqx
Possible decryption with key qke: Dtcoc uqst qcmdpl ginomaj gjcr awc nomrqw
Possible decryption with key qkn: Dttoc uqjt hcmupl gieomrj xjci anc eomiqw
Possible decryption with key qks: Dtooc uqet ccmppl gizommj sjcd aic zomdqw
Possible decryption with key qky: Dtioc uqyt wcmjpl gitomgj mjcx acc tomxqw
Possible decryption with key qkz: Dthoc uqxt vcmipl gisomfj ljcw abc somwqw
Possible decryption with key qln: Dstob upjt hclupk gheolrj xjbi znc eoliqv
Possible decryption with key qly: Dsiob upyt wcljpk ghtolgj mjbx zcc tolxqv
Possible decryption with key qmn: Drtoa uojt hckupj ggeokrj xjai ync eokiqu
Possible decryption with key qmr: Drpoa uoft dckqpj ggaoknj tjae yjc aokequ
Possible decryption with key qmy: Drioa uoyt wckjpj ggtokgj mjax ycc tokxqu
Possible decryption with key qnn: Dqtoz unjt hcjupi gfeojrj xjzi xnc eojiqt
Possible decryption with key qny: Dqioz unyt wcjjpi gftojgj mjzx xcc tojxqt
Possible decryption with key qod: Dpdoy umtt rcieph geooibj hjys wxc ooisqs
Possible decryption with key qoi: Dpyoy umot mcizph gejoiwj cjyn wsc joinqs
Possible decryption with key qom: Dpuoy umkt icivph gefoisj yjyj woc foijqs
Possible decryption with key qon: Dptoy umjt hciuph geeoirj xjyi wnc eoiiqs
Possible decryption with key qop: Dproy umht fcisph gecoipj vjyg wlc coigqs
Possible decryption with key qor: Dppoy umft dciqph geaoinj tjye wjc aoieqs
Possible decryption with key qou: Dpmoy umct acinph gexoikj qjyb wgc xoibqs
Possible decryption with key qoy: Dpioy umyt wcijph getoigj mjyx wcc toixqs
Possible decryption with key qpb: Dofox ulvt tchgpg gdqohdj jjxu vzc qohuqr
Possible decryption with key qpn: Dotox uljt hchupg gdeohrj xjxi vnc eohiqr
Possible decryption with key qpy: Doiox ulyt wchjpg gdtohgj mjxx vcc tohxqr
Possible decryption with key qqn: Dntow ukjt hcgupf gceogrj xjwi unc eogiqq
Possible decryption with key qqy: Dniow ukyt wcgjpf gctoggj mjwx ucc togxqq
Possible decryption with key qra: Dmgov ujwt ucfhpe gbrofej kjvv tac rofvqp
Possible decryption with key qrb: Dmfov ujvt tcfgpe gbqofdj jjvu tzc qofuqp
Possible decryption with key qrc: Dmeov ujut scffpe gbpofcj ijvt tyc poftqp
Possible decryption with key qrd: Dmdov ujtt rcfepe gboofbj hjvs txc oofsqp
Possible decryption with key qre: Dmcov ujst qcfdpe gbnofaj gjvr twc nofrqp
Possible decryption with key qrf: Dmbov ujrt pcfcpe gbmofzj fjvq tvc mofqqp
Possible decryption with key qrg: Dmaov ujqt ocfbpe gblofyj ejvp tuc lofpqp
Possible decryption with key qrh: Dmzov ujpt ncfape gbkofxj djvo ttc kofoqp
Possible decryption with key qri: Dmyov ujot mcfzpe gbjofwj cjvn tsc jofnqp
Possible decryption with key qrj: Dmxov ujnt lcfype gbiofvj bjvm trc iofmqp
Possible decryption with key qrk: Dmwov ujmt kcfxpe gbhofuj ajvl tqc hoflqp
Possible decryption with key qrl: Dmvov ujlt jcfwpe gbgoftj zjvk tpc gofkqp
Possible decryption with key qrm: Dmuov ujkt icfvpe gbfofsj yjvj toc fofjqp
Possible decryption with key qrn: Dmtov ujjt hcfupe gbeofrj xjvi tnc eofiqp
Possible decryption with key qro: Dmsov ujit gcftpe gbdofqj wjvh tmc dofhqp
Possible decryption with key qrp: Dmrov ujht fcfspe gbcofpj vjvg tlc cofgqp
Possible decryption with key qrq: Dmqov ujgt ecfrpe gbbofoj ujvf tkc boffqp
Possible decryption with key qrr: Dmpov ujft dcfqpe gbaofnj tjve tjc aofeqp
Possible decryption with key qrs: Dmoov ujet ccfppe gbzofmj sjvd tic zofdqp
Possible decryption with key qrt: Dmnov ujdt bcfope gbyoflj rjvc thc yofcqp
Possible decryption with key qru: Dmmov ujct acfnpe gbxofkj qjvb tgc xofbqp
Possible decryption with key qrv: Dmlov ujbt zcfmpe gbwofjj pjva tfc wofaqp
Possible decryption with key qrw: Dmkov ujat ycflpe gbvofij ojvz tec vofzqp
Possible decryption with key qrx: Dmjov ujzt xcfkpe gbuofhj njvy tdc uofyqp
Possible decryption with key qry: Dmiov ujyt wcfjpe gbtofgj mjvx tcc tofxqp
Possible decryption with key qrz: Dmhov ujxt vcfipe gbsoffj ljvw tbc sofwqp
Possible decryption with key qse: Dlcou uist qcedpd ganoeaj gjur swc noerqo
Possible decryption with key qsj: Dlxou uint lceypd gaioevj bjum src ioemqo
Possible decryption with key qsn: Dltou uijt hceupd gaeoerj xjui snc eoeiqo
Possible decryption with key qsy: Dliou uiyt wcejpd gatoegj mjux scc toexqo
Possible decryption with key qth: Dkzot uhpt ncdapc gzkodxj djto rtc kodoqn
Possible decryption with key qtn: Dktot uhjt hcdupc gzeodrj xjti rnc eodiqn
Possible decryption with key qty: Dkiot uhyt wcdjpc gztodgj mjtx rcc todxqn
Possible decryption with key qun: Djtos ugjt hccupb gyeocrj xjsi qnc eociqm
Possible decryption with key quy: Djios ugyt wccjpb gytocgj mjsx qcc tocxqm
Possible decryption with key qvn: Ditor ufjt hcbupa gxeobrj xjri pnc eobiql
Possible decryption with key qvo: Disor ufit gcbtpa gxdobqj wjrh pmc dobhql
Possible decryption with key qvt: Dinor ufdt bcbopa gxyoblj rjrc phc yobcql
Possible decryption with key qvy: Diior ufyt wcbjpa gxtobgj mjrx pcc tobxql
Possible decryption with key qwn: Dhtoq uejt hcaupz gweoarj xjqi onc eoaiqk
Possible decryption with key qwv: Dhloq uebt zcampz gwwoajj pjqa ofc woaaqk
Possible decryption with key qwy: Dhioq ueyt wcajpz gwtoagj mjqx occ toaxqk
Possible decryption with key qxn: Dgtop udjt hczupy gveozrj xjpi nnc eoziqj
Possible decryption with key qxy: Dgiop udyt wczjpy gvtozgj mjpx ncc tozxqj
Possible decryption with key qyn: Dftoo ucjt hcyupx gueoyrj xjoi mnc eoyiqi
Possible decryption with key qyq: Dfqoo ucgt ecyrpx guboyoj ujof mkc boyfqi
Possible decryption with key qyy: Dfioo ucyt wcyjpx gutoygj mjox mcc toyxqi
Possible decryption with key qzd: Dedon ubtt rcxepw gtooxbj hjns lxc ooxsqh
Possible decryption with key qzn: Deton ubjt hcxupw gteoxrj xjni lnc eoxiqh
Possible decryption with key qzy: Deion ubyt wcxjpw gttoxgj mjnx lcc toxxqh
Possible decryption with key raj: Cdxnm tans lbwyov fsinwvi bimm krb inwmpg
Possible decryption with key rao: Cdsnm tais gbwtov fsdnwqi wimh kmb dnwhpg
Possible decryption with key ray: Cdinm tays wbwjov fstnwgi mimx kcb tnwxpg
Possible decryption with key rbj: Ccxnl tzns lbvyou frinvvi bilm jrb invmpf
Possible decryption with key rbo: Ccsnl tzis gbvtou frdnvqi wilh jmb dnvhpf
Possible decryption with key rby: Ccinl tzys wbvjou frtnvgi milx jcb tnvxpf
Possible decryption with key rci: Cbynk tyos mbuzot fqjnuwi cikn isb jnunpe
Possible decryption with key rcj: Cbxnk tyns lbuyot fqinuvi bikm irb inumpe
Possible decryption with key rcn: Cbtnk tyjs hbuuot fqenuri xiki inb enuipe
Possible decryption with key rco: Cbsnk tyis gbutot fqdnuqi wikh imb dnuhpe
Possible decryption with key rcy: Cbink tyys wbujot fqtnugi mikx icb tnuxpe
Possible decryption with key rdh: Caznj txps nbtaos fpkntxi dijo htb kntopd
Possible decryption with key rdj: Caxnj txns lbtyos fpintvi bijm hrb intmpd
Possible decryption with key rdo: Casnj txis gbttos fpdntqi wijh hmb dnthpd
Possible decryption with key rdq: Caqnj txgs ebtros fpbntoi uijf hkb bntfpd
Possible decryption with key rdt: Cannj txds bbtoos fpyntli rijc hhb yntcpd
Possible decryption with key rdy: Cainj txys wbtjos fptntgi mijx hcb tntxpd
Possible decryption with key red: Czdni twts rbseor foonsbi hiis gxb onsspc
Possible decryption with key rei: Czyni twos mbszor fojnswi ciin gsb jnsnpc
Possible decryption with key rej: Czxni twns lbsyor foinsvi biim grb insmpc
Possible decryption with key rem: Czuni twks ibsvor fofnssi yiij gob fnsjpc
Possible decryption with key reo: Czsni twis gbstor fodnsqi wiih gmb dnshpc
Possible decryption with key rey: Czini twys wbsjor fotnsgi miix gcb tnsxpc
Possible decryption with key rfj: Cyxnh tvns lbryoq fninrvi bihm frb inrmpb
Possible decryption with key rfo: Cysnh tvis gbrtoq fndnrqi wihh fmb dnrhpb
Possible decryption with key rfy: Cyinh tvys wbrjoq fntnrgi mihx fcb tnrxpb
Possible decryption with key rgj: Cxxng tuns lbqyop fminqvi bigm erb inqmpa
Possible decryption with key rgo: Cxsng tuis gbqtop fmdnqqi wigh emb dnqhpa
Possible decryption with key rgy: Cxing tuys wbqjop fmtnqgi migx ecb tnqxpa
Possible decryption with key rhi: Cwynf ttos mbpzoo fljnpwi cifn dsb jnpnpz
Possible decryption with key rhj: Cwxnf ttns lbpyoo flinpvi bifm drb inpmpz
Possible decryption with key rho: Cwsnf ttis gbptoo fldnpqi wifh dmb dnphpz
Possible decryption with key rhy: Cwinf ttys wbpjoo fltnpgi mifx dcb tnpxpz
Possible decryption with key ric: Cvene tsus sbofon fkpnoci iiet cyb pnotpy
Possible decryption with key rij: Cvxne tsns lboyon fkinovi biem crb inompy
Possible decryption with key rio: Cvsne tsis gboton fkdnoqi wieh cmb dnohpy
Possible decryption with key riq: Cvqne tsgs eboron fkbnooi uief ckb bnofpy
Possible decryption with key riy: Cvine tsys wbojon fktnogi miex ccb tnoxpy
Possible decryption with key riz: Cvhne tsxs vboion fksnofi liew cbb snowpy
Possible decryption with key rjg: Cuand trqs obnbom fjlnnyi eidp bub lnnppx
Possible decryption with key rjj: Cuxnd trns lbnyom fjinnvi bidm brb innmpx
Possible decryption with key rjo: Cusnd tris gbntom fjdnnqi widh bmb dnnhpx
Possible decryption with key rjy: Cuind trys wbnjom fjtnngi midx bcb tnnxpx
Possible decryption with key rke: Ctcnc tqss qbmdol finnmai gicr awb nnmrpw
Possible decryption with key rkj: Ctxnc tqns lbmyol fiinmvi bicm arb inmmpw
Possible decryption with key rko: Ctsnc tqis gbmtol fidnmqi wich amb dnmhpw
Possible decryption with key rks: Ctonc tqes cbmpol fiznmmi sicd aib znmdpw
Possible decryption with key rky: Ctinc tqys wbmjol fitnmgi micx acb tnmxpw
Possible decryption with key rkz: Cthnc tqxs vbmiol fisnmfi licw abb snmwpw
Possible decryption with key rlj: Csxnb tpns lblyok fhinlvi bibm zrb inlmpv
Possible decryption with key rlo: Cssnb tpis gbltok fhdnlqi wibh zmb dnlhpv
Possible decryption with key rly: Csinb tpys wbljok fhtnlgi mibx zcb tnlxpv
Possible decryption with key rma: Crgna tows ubkhoj fgrnkei kiav yab rnkvpu
Possible decryption with key rmb: Crfna tovs tbkgoj fgqnkdi jiau yzb qnkupu
Possible decryption with key rmc: Crena tous sbkfoj fgpnkci iiat yyb pnktpu
Possible decryption with key rmd: Crdna tots rbkeoj fgonkbi hias yxb onkspu
Possible decryption with key rme: Crcna toss qbkdoj fgnnkai giar ywb nnkrpu
Possible decryption with key rmf: Crbna tors pbkcoj fgmnkzi fiaq yvb mnkqpu
Possible decryption with key rmg: Crana toqs obkboj fglnkyi eiap yub lnkppu
Possible decryption with key rmh: Crzna tops nbkaoj fgknkxi diao ytb knkopu
Possible decryption with key rmi: Cryna toos mbkzoj fgjnkwi cian ysb jnknpu
Possible decryption with key rmj: Crxna tons lbkyoj fginkvi biam yrb inkmpu
Possible decryption with key rmk: Crwna toms kbkxoj fghnkui aial yqb hnklpu
Possible decryption with key rml: Crvna tols jbkwoj fggnkti ziak ypb gnkkpu
Possible decryption with key rmm: Cruna toks ibkvoj fgfnksi yiaj yob fnkjpu
Possible decryption with key rmn: Crtna tojs hbkuoj fgenkri xiai ynb enkipu
Possible decryption with key rmo: Crsna tois gbktoj fgdnkqi wiah ymb dnkhpu
Possible decryption with key rmp: Crrna tohs fbksoj fgcnkpi viag ylb cnkgpu
Possible decryption with key rmq: Crqna togs ebkroj fgbnkoi uiaf ykb bnkfpu
Possible decryption with key rmr: Crpna tofs dbkqoj fgankni tiae yjb ankepu
Possible decryption with key rms: Crona toes cbkpoj fgznkmi siad yib znkdpu
Possible decryption with key rmt: Crnna tods bbkooj fgynkli riac yhb ynkcpu
Possible decryption with key rmu: Crmna tocs abknoj fgxnkki qiab ygb xnkbpu
Possible decryption with key rmv: Crlna tobs zbkmoj fgwnkji piaa yfb wnkapu
Possible decryption with key rmw: Crkna toas ybkloj fgvnkii oiaz yeb vnkzpu
Possible decryption with key rmx: Crjna tozs xbkkoj fgunkhi niay ydb unkypu
Possible decryption with key rmy: Crina toys wbkjoj fgtnkgi miax ycb tnkxpu
Possible decryption with key rmz: Crhna toxs vbkioj fgsnkfi liaw ybb snkwpu
Possible decryption with key rnj: Cqxnz tnns lbjyoi ffinjvi bizm xrb injmpt
Possible decryption with key rno: Cqsnz tnis gbjtoi ffdnjqi wizh xmb dnjhpt
Possible decryption with key rny: Cqinz tnys wbjjoi fftnjgi mizx xcb tnjxpt
Possible decryption with key rod: Cpdny tmts rbieoh feonibi hiys wxb onisps
Possible decryption with key roi: Cpyny tmos mbizoh fejniwi ciyn wsb jninps
Possible decryption with key roj: Cpxny tmns lbiyoh feinivi biym wrb inimps
Possible decryption with key rom: Cpuny tmks ibivoh fefnisi yiyj wob fnijps
Possible decryption with key roo: Cpsny tmis gbitoh fedniqi wiyh wmb dnihps
Possible decryption with key rop: Cprny tmhs fbisoh fecnipi viyg wlb cnigps
Possible decryption with key ror: Cppny tmfs dbiqoh feanini tiye wjb anieps
Possible decryption with key rou: Cpmny tmcs abinoh fexniki qiyb wgb xnibps
Possible decryption with key roy: Cpiny tmys wbijoh fetnigi miyx wcb tnixps
Possible decryption with key rpb: Cofnx tlvs tbhgog fdqnhdi jixu vzb qnhupr
Possible decryption with key rpj: Coxnx tlns lbhyog fdinhvi bixm vrb inhmpr
Possible decryption with key rpo: Cosnx tlis gbhtog fddnhqi wixh vmb dnhhpr
Possible decryption with key rpy: Coinx tlys wbhjog fdtnhgi mixx vcb tnhxpr
Possible decryption with key rqa: Cngnw tkws ubghof fcrngei kiwv uab rngvpq
Possible decryption with key rqb: Cnfnw tkvs tbggof fcqngdi jiwu uzb qngupq
Possible decryption with key rqc: Cnenw tkus sbgfof fcpngci iiwt uyb pngtpq
Possible decryption with key rqd: Cndnw tkts rbgeof fcongbi hiws uxb ongspq
Possible decryption with key rqe: Cncnw tkss qbgdof fcnngai giwr uwb nngrpq
Possible decryption with key rqf: Cnbnw tkrs pbgcof fcmngzi fiwq uvb mngqpq
Possible decryption with key rqg: Cnanw tkqs obgbof fclngyi eiwp uub lngppq
Possible decryption with key rqh: Cnznw tkps nbgaof fckngxi diwo utb kngopq
Possible decryption with key rqi: Cnynw tkos mbgzof fcjngwi ciwn usb jngnpq
Possible decryption with key rqj: Cnxnw tkns lbgyof fcingvi biwm urb ingmpq
Possible decryption with key rqk: Cnwnw tkms kbgxof fchngui aiwl uqb hnglpq
Possible decryption with key rql: Cnvnw tkls jbgwof fcgngti ziwk upb gngkpq
Possible decryption with key rqm: Cnunw tkks ibgvof fcfngsi yiwj uob fngjpq
Possible decryption with key rqn: Cntnw tkjs hbguof fcengri xiwi unb engipq
Possible decryption with key rqo: Cnsnw tkis gbgtof fcdngqi wiwh umb dnghpq
Possible decryption with key rqp: Cnrnw tkhs fbgsof fccngpi viwg ulb cnggpq
Possible decryption with key rqq: Cnqnw tkgs ebgrof fcbngoi uiwf ukb bngfpq
Possible decryption with key rqr: Cnpnw tkfs dbgqof fcangni tiwe ujb angepq
Possible decryption with key rqs: Cnonw tkes cbgpof fczngmi siwd uib zngdpq
Possible decryption with key rqt: Cnnnw tkds bbgoof fcyngli riwc uhb yngcpq
Possible decryption with key rqu: Cnmnw tkcs abgnof fcxngki qiwb ugb xngbpq
Possible decryption with key rqv: Cnlnw tkbs zbgmof fcwngji piwa ufb wngapq
Possible decryption with key rqw: Cnknw tkas ybglof fcvngii oiwz ueb vngzpq
Possible decryption with key rqx: Cnjnw tkzs xbgkof fcunghi niwy udb ungypq
Possible decryption with key rqy: Cninw tkys wbgjof fctnggi miwx ucb tngxpq
Possible decryption with key rqz: Cnhnw tkxs vbgiof fcsngfi liww ubb sngwpq
Possible decryption with key rrj: Cmxnv tjns lbfyoe fbinfvi bivm trb infmpp
Possible decryption with key rrm: Cmunv tjks ibfvoe fbfnfsi yivj tob fnfjpp
Possible decryption with key rro: Cmsnv tjis gbftoe fbdnfqi wivh tmb dnfhpp
Possible decryption with key rry: Cminv tjys wbfjoe fbtnfgi mivx tcb tnfxpp
Possible decryption with key rse: Clcnu tiss qbedod fanneai giur swb nnerpo
Possible decryption with key rsj: Clxnu tins lbeyod fainevi bium srb inempo
Possible decryption with key rso: Clsnu tiis gbetod fadneqi wiuh smb dnehpo
Possible decryption with key rsy: Clinu tiys wbejod fatnegi miux scb tnexpo
Possible decryption with key rth: Ckznt thps nbdaoc fzkndxi dito rtb kndopn
Possible decryption with key rtj: Ckxnt thns lbdyoc fzindvi bitm rrb indmpn
Possible decryption with key rto: Cksnt this gbdtoc fzdndqi with rmb dndhpn
Possible decryption with key rtr: Ckpnt thfs dbdqoc fzandni tite rjb andepn
Possible decryption with key rts: Ckont thes cbdpoc fzzndmi sitd rib znddpn
Possible decryption with key rty: Ckint thys wbdjoc fztndgi mitx rcb tndxpn
Possible decryption with key rua: Cjgns tgws ubchob fyrncei kisv qab rncvpm
Possible decryption with key rub: Cjfns tgvs tbcgob fyqncdi jisu qzb qncupm
Possible decryption with key ruc: Cjens tgus sbcfob fypncci iist qyb pnctpm
Possible decryption with key rud: Cjdns tgts rbceob fyoncbi hiss qxb oncspm
Possible decryption with key rue: Cjcns tgss qbcdob fynncai gisr qwb nncrpm
Possible decryption with key ruf: Cjbns tgrs pbccob fymnczi fisq qvb mncqpm
Possible decryption with key rug: Cjans tgqs obcbob fylncyi eisp qub lncppm
Possible decryption with key ruh: Cjzns tgps nbcaob fykncxi diso qtb kncopm
Possible decryption with key rui: Cjyns tgos mbczob fyjncwi cisn qsb jncnpm
Possible decryption with key ruj: Cjxns tgns lbcyob fyincvi bism qrb incmpm
Possible decryption with key ruk: Cjwns tgms kbcxob fyhncui aisl qqb hnclpm
Possible decryption with key rul: Cjvns tgls jbcwob fygncti zisk qpb gnckpm
Possible decryption with key rum: Cjuns tgks ibcvob fyfncsi yisj qob fncjpm
Possible decryption with key run: Cjtns tgjs hbcuob fyencri xisi qnb encipm
Possible decryption with key ruo: Cjsns tgis gbctob fydncqi wish qmb dnchpm
Possible decryption with key rup: Cjrns tghs fbcsob fycncpi visg qlb cncgpm
Possible decryption with key ruq: Cjqns tggs ebcrob fybncoi uisf qkb bncfpm
Possible decryption with key rur: Cjpns tgfs dbcqob fyancni tise qjb ancepm
Possible decryption with key rus: Cjons tges cbcpob fyzncmi sisd qib zncdpm
Possible decryption with key rut: Cjnns tgds bbcoob fyyncli risc qhb ynccpm
Possible decryption with key ruu: Cjmns tgcs abcnob fyxncki qisb qgb xncbpm
Possible decryption with key ruv: Cjlns tgbs zbcmob fywncji pisa qfb wncapm
Possible decryption with key ruw: Cjkns tgas ybclob fyvncii oisz qeb vnczpm
Possible decryption with key rux: Cjjns tgzs xbckob fyunchi nisy qdb uncypm
Possible decryption with key ruy: Cjins tgys wbcjob fytncgi misx qcb tncxpm
Possible decryption with key ruz: Cjhns tgxs vbciob fysncfi lisw qbb sncwpm
Possible decryption with key rvj: Cixnr tfns lbbyoa fxinbvi birm prb inbmpl
Possible decryption with key rvo: Cisnr tfis gbbtoa fxdnbqi wirh pmb dnbhpl
Possible decryption with key rvt: Cinnr tfds bbbooa fxynbli rirc phb ynbcpl
Possible decryption with key rvy: Ciinr tfys wbbjoa fxtnbgi mirx pcb tnbxpl
Possible decryption with key rwj: Chxnq tens lbayoz fwinavi biqm orb inampk
Possible decryption with key rwo: Chsnq teis gbatoz fwdnaqi wiqh omb dnahpk
Possible decryption with key rwv: Chlnq tebs zbamoz fwwnaji piqa ofb wnaapk
Possible decryption with key rwy: Chinq teys wbajoz fwtnagi miqx ocb tnaxpk
Possible decryption with key rxj: Cgxnp tdns lbzyoy fvinzvi bipm nrb inzmpj
Possible decryption with key rxo: Cgsnp tdis gbztoy fvdnzqi wiph nmb dnzhpj
Possible decryption with key rxy: Cginp tdys wbzjoy fvtnzgi mipx ncb tnzxpj
Possible decryption with key ryj: Cfxno tcns lbyyox fuinyvi biom mrb inympi
Possible decryption with key ryo: Cfsno tcis gbytox fudnyqi wioh mmb dnyhpi
Possible decryption with key ryq: Cfqno tcgs ebyrox fubnyoi uiof mkb bnyfpi
Possible decryption with key ryy: Cfino tcys wbyjox futnygi miox mcb tnyxpi
Possible decryption with key rza: Cegnn tbws ubxhow ftrnxei kinv lab rnxvph
Possible decryption with key rzb: Cefnn tbvs tbxgow ftqnxdi jinu lzb qnxuph
Possible decryption with key rzc: Ceenn tbus sbxfow ftpnxci iint lyb pnxtph
Possible decryption with key rzd: Cednn tbts rbxeow ftonxbi hins lxb onxsph
Possible decryption with key rze: Cecnn tbss qbxdow ftnnxai ginr lwb nnxrph
Possible decryption with key rzf: Cebnn tbrs pbxcow ftmnxzi finq lvb mnxqph
Possible decryption with key rzg: Ceann tbqs obxbow ftlnxyi einp lub lnxpph
Possible decryption with key rzh: Ceznn tbps nbxaow ftknxxi dino ltb knxoph
Possible decryption with key rzi: Ceynn tbos mbxzow ftjnxwi cinn lsb jnxnph
Possible decryption with key rzj: Cexnn tbns lbxyow ftinxvi binm lrb inxmph
Possible decryption with key rzk: Cewnn tbms kbxxow fthnxui ainl lqb hnxlph
Possible decryption with key rzl: Cevnn tbls jbxwow ftgnxti zink lpb gnxkph
Possible decryption with key rzm: Ceunn tbks ibxvow ftfnxsi yinj lob fnxjph
Possible decryption with key rzn: Cetnn tbjs hbxuow ftenxri xini lnb enxiph
Possible decryption with key rzo: Cesnn tbis gbxtow ftdnxqi winh lmb dnxhph
Possible decryption with key rzp: Cernn tbhs fbxsow ftcnxpi ving llb cnxgph
Possible decryption with key rzq: Ceqnn tbgs ebxrow ftbnxoi uinf lkb bnxfph
Possible decryption with key rzr: Cepnn tbfs dbxqow ftanxni tine ljb anxeph
Possible decryption with key rzs: Ceonn tbes cbxpow ftznxmi sind lib znxdph
Possible decryption with key rzt: Cennn tbds bbxoow ftynxli rinc lhb ynxcph
Possible decryption with key rzu: Cemnn tbcs abxnow ftxnxki qinb lgb xnxbph
Possible decryption with key rzv: Celnn tbbs zbxmow ftwnxji pina lfb wnxaph
Possible decryption with key rzw: Ceknn tbas ybxlow ftvnxii oinz leb vnxzph
Possible decryption with key rzx: Cejnn tbzs xbxkow ftunxhi niny ldb unxyph
Possible decryption with key rzy: Ceinn tbys wbxjow fttnxgi minx lcb tnxxph
Possible decryption with key rzz: Cehnn tbxs vbxiow ftsnxfi linw lbb snxwph
Possible decryption with key sac: Bdemm saur sawfnv espmwch ihmt kya pmwtog
Possible decryption with key saz: Bdhmm saxr vawinv essmwfh lhmw kba smwwog
Possible decryption with key sba: Bcgml szwr uavhnu errmveh khlv jaa rmvvof
Possible decryption with key sbb: Bcfml szvr tavgnu erqmvdh jhlu jza qmvuof
Possible decryption with key sbc: Bceml szur savfnu erpmvch ihlt jya pmvtof
Possible decryption with key sbd: Bcdml sztr ravenu eromvbh hhls jxa omvsof
Possible decryption with key sbe: Bccml szsr qavdnu ernmvah ghlr jwa nmvrof
Possible decryption with key sbf: Bcbml szrr pavcnu ermmvzh fhlq jva mmvqof
Possible decryption with key sbg: Bcaml szqr oavbnu erlmvyh ehlp jua lmvpof
Possible decryption with key sbh: Bczml szpr navanu erkmvxh dhlo jta kmvoof
Possible decryption with key sbi: Bcyml szor mavznu erjmvwh chln jsa jmvnof
Possible decryption with key sbj: Bcxml sznr lavynu erimvvh bhlm jra imvmof
Possible decryption with key sbk: Bcwml szmr kavxnu erhmvuh ahll jqa hmvlof
Possible decryption with key sbl: Bcvml szlr javwnu ergmvth zhlk jpa gmvkof
Possible decryption with key sbm: Bcuml szkr iavvnu erfmvsh yhlj joa fmvjof
Possible decryption with key sbn: Bctml szjr havunu eremvrh xhli jna emviof
Possible decryption with key sbo: Bcsml szir gavtnu erdmvqh whlh jma dmvhof
Possible decryption with key sbp: Bcrml szhr favsnu ercmvph vhlg jla cmvgof
Possible decryption with key sbq: Bcqml szgr eavrnu erbmvoh uhlf jka bmvfof
Possible decryption with key sbr: Bcpml szfr davqnu eramvnh thle jja amveof
Possible decryption with key sbs: Bcoml szer cavpnu erzmvmh shld jia zmvdof
Possible decryption with key sbt: Bcnml szdr bavonu erymvlh rhlc jha ymvcof
Possible decryption with key sbu: Bcmml szcr aavnnu erxmvkh qhlb jga xmvbof
Possible decryption with key sbv: Bclml szbr zavmnu erwmvjh phla jfa wmvaof
Possible decryption with key sbw: Bckml szar yavlnu ervmvih ohlz jea vmvzof
Possible decryption with key sbx: Bcjml szzr xavknu erumvhh nhly jda umvyof
Possible decryption with key sby: Bciml szyr wavjnu ertmvgh mhlx jca tmvxof
Possible decryption with key sbz: Bchml szxr vavinu ersmvfh lhlw jba smvwof
Possible decryption with key scc: Bbemk syur saufnt eqpmuch ihkt iya pmutoe
Possible decryption with key sci: Bbymk syor mauznt eqjmuwh chkn isa jmunoe
Possible decryption with key scn: Bbtmk syjr hauunt eqemurh xhki ina emuioe
Possible decryption with key scz: Bbhmk syxr vauint eqsmufh lhkw iba smuwoe
Possible decryption with key sdc: Baemj sxur satfns eppmtch ihjt hya pmttod
Possible decryption with key sdh: Bazmj sxpr natans epkmtxh dhjo hta kmtood
Possible decryption with key sdq: Baqmj sxgr eatrns epbmtoh uhjf hka bmtfod
Possible decryption with key sdt: Banmj sxdr batons epymtlh rhjc hha ymtcod
Possible decryption with key sdz: Bahmj sxxr vatins epsmtfh lhjw hba smtwod
Possible decryption with key sec: Bzemi swur sasfnr eopmsch ihit gya pmstoc
Possible decryption with key sed: Bzdmi swtr rasenr eoomsbh hhis gxa omssoc
Possible decryption with key sei: Bzymi swor masznr eojmswh chin gsa jmsnoc
Possible decryption with key sem: Bzumi swkr iasvnr eofmssh yhij goa fmsjoc
Possible decryption with key sez: Bzhmi swxr vasinr eosmsfh lhiw gba smswoc
Possible decryption with key sfc: Byemh svur sarfnq enpmrch ihht fya pmrtob
Possible decryption with key sfz: Byhmh svxr varinq ensmrfh lhhw fba smrwob
Possible decryption with key sgc: Bxemg suur saqfnp empmqch ihgt eya pmqtoa
Possible decryption with key sgz: Bxhmg suxr vaqinp emsmqfh lhgw eba smqwoa
Possible decryption with key shc: Bwemf stur sapfno elpmpch ihft dya pmptoz
Possible decryption with key shi: Bwymf stor mapzno eljmpwh chfn dsa jmpnoz
Possible decryption with key shz: Bwhmf stxr vapino elsmpfh lhfw dba smpwoz
Possible decryption with key sic: Bveme ssur saofnn ekpmoch ihet cya pmotoy
Possible decryption with key siq: Bvqme ssgr eaornn ekbmooh uhef cka bmofoy
Possible decryption with key sir: Bvpme ssfr daoqnn ekamonh thee cja amoeoy
Possible decryption with key siz: Bvhme ssxr vaoinn eksmofh lhew cba smowoy
Possible decryption with key sjc: Buemd srur sanfnm ejpmnch ihdt bya pmntox
Possible decryption with key sje: Bucmd srsr qandnm ejnmnah ghdr bwa nmnrox
Possible decryption with key sjz: Buhmd srxr vaninm ejsmnfh lhdw bba smnwox
Possible decryption with key skc: Btemc squr samfnl eipmmch ihct aya pmmtow
Possible decryption with key ske: Btcmc sqsr qamdnl einmmah ghcr awa nmmrow
Possible decryption with key sks: Btomc sqer campnl eizmmmh shcd aia zmmdow
Possible decryption with key skz: Bthmc sqxr vaminl eismmfh lhcw aba smmwow
Possible decryption with key slc: Bsemb spur salfnk ehpmlch ihbt zya pmltov
Possible decryption with key slz: Bshmb spxr valink ehsmlfh lhbw zba smlwov
Possible decryption with key smc: Brema sour sakfnj egpmkch ihat yya pmktou
Possible decryption with key smr: Brpma sofr dakqnj egamknh thae yja amkeou
Possible decryption with key smz: Brhma soxr vakinj egsmkfh lhaw yba smkwou
Possible decryption with key snc: Bqemz snur sajfni efpmjch ihzt xya pmjtot
Possible decryption with key snz: Bqhmz snxr vajini efsmjfh lhzw xba smjwot
Possible decryption with key soc: Bpemy smur saifnh eepmich ihyt wya pmitos
Possible decryption with key sod: Bpdmy smtr raienh eeomibh hhys wxa omisos
Possible decryption with key soi: Bpymy smor maiznh eejmiwh chyn wsa jminos
Possible decryption with key som: Bpumy smkr iaivnh eefmish yhyj woa fmijos
Possible decryption with key sop: Bprmy smhr faisnh eecmiph vhyg wla cmigos
Possible decryption with key sor: Bppmy smfr daiqnh eeaminh thye wja amieos
Possible decryption with key sou: Bpmmy smcr aainnh eexmikh qhyb wga xmibos
Possible decryption with key soz: Bphmy smxr vaiinh eesmifh lhyw wba smiwos
Possible decryption with key spb: Bofmx slvr tahgng edqmhdh jhxu vza qmhuor
Possible decryption with key spc: Boemx slur sahfng edpmhch ihxt vya pmhtor
Possible decryption with key spz: Bohmx slxr vahing edsmhfh lhxw vba smhwor
Possible decryption with key sqc: Bnemw skur sagfnf ecpmgch ihwt uya pmgtoq
Possible decryption with key sqz: Bnhmw skxr vaginf ecsmgfh lhww uba smgwoq
Possible decryption with key src: Bmemv sjur saffne ebpmfch ihvt tya pmftop
Possible decryption with key srm: Bmumv sjkr iafvne ebfmfsh yhvj toa fmfjop
Possible decryption with key srz: Bmhmv sjxr vafine ebsmffh lhvw tba smfwop
Possible decryption with key ssc: Blemu siur saefnd eapmech ihut sya pmetoo
Possible decryption with key sse: Blcmu sisr qaednd eanmeah ghur swa nmeroo
Possible decryption with key ssh: Blzmu sipr naeand eakmexh dhuo sta kmeooo
Possible decryption with key ssj: Blxmu sinr laeynd eaimevh bhum sra imemoo
Possible decryption with key ssz: Blhmu sixr vaeind easmefh lhuw sba smewoo
Possible decryption with key stc: Bkemt shur sadfnc ezpmdch ihtt rya pmdton
Possible decryption with key sth: Bkzmt shpr nadanc ezkmdxh dhto rta kmdoon
Possible decryption with key stz: Bkhmt shxr vadinc ezsmdfh lhtw rba smdwon
Possible decryption with key suc: Bjems sgur sacfnb eypmcch ihst qya pmctom
Possible decryption with key suz: Bjhms sgxr vacinb eysmcfh lhsw qba smcwom
Possible decryption with key svc: Biemr sfur sabfna expmbch ihrt pya pmbtol
Possible decryption with key svo: Bismr sfir gabtna exdmbqh whrh pma dmbhol
Possible decryption with key svt: Binmr sfdr babona exymblh rhrc pha ymbcol
Possible decryption with key svz: Bihmr sfxr vabina exsmbfh lhrw pba smbwol
Possible decryption with key swc: Bhemq seur saafnz ewpmach ihqt oya pmatok
Possible decryption with key swv: Bhlmq sebr zaamnz ewwmajh phqa ofa wmaaok
Possible decryption with key swz: Bhhmq sexr vaainz ewsmafh lhqw oba smawok
Possible decryption with key sxc: Bgemp sdur sazfny evpmzch ihpt nya pmztoj
Possible decryption with key sxz: Bghmp sdxr vaziny evsmzfh lhpw nba smzwoj
Possible decryption with key syc: Bfemo scur sayfnx eupmych ihot mya pmytoi
Possible decryption with key syq: Bfqmo scgr eayrnx eubmyoh uhof mka bmyfoi
Possible decryption with key syz: Bfhmo scxr vayinx eusmyfh lhow mba smywoi
Possible decryption with key szc: Beemn sbur saxfnw etpmxch ihnt lya pmxtoh
Possible decryption with key szd: Bedmn sbtr raxenw etomxbh hhns lxa omxsoh
Possible decryption with key szz: Behmn sbxr vaxinw etsmxfh lhnw lba smxwoh
Possible decryption with key tan: Adtlm rajq hzwumv dselwrg xgmi knz elwing
Possible decryption with key tbn: Actll rzjq hzvumu drelvrg xgli jnz elvinf
Possible decryption with key tci: Abylk ryoq mzuzmt dqjluwg cgkn isz jlunne
Possible decryption with key tcn: Abtlk ryjq hzuumt dqelurg xgki inz eluine
Possible decryption with key tdh: Aazlj rxpq nztams dpkltxg dgjo htz kltond
Possible decryption with key tdn: Aatlj rxjq hztums dpeltrg xgji hnz eltind
Possible decryption with key tdq: Aaqlj rxgq eztrms dpbltog ugjf hkz bltfnd
Possible decryption with key tdt: Aanlj rxdq bztoms dpyltlg rgjc hhz yltcnd
Possible decryption with key tdv: Aallj rxbq zztmms dpwltjg pgja hfz wltand
Possible decryption with key ted: Azdli rwtq rzsemr doolsbg hgis gxz olssnc
Possible decryption with key tei: Azyli rwoq mzszmr dojlswg cgin gsz jlsnnc
Possible decryption with key tem: Azuli rwkq izsvmr doflssg ygij goz flsjnc
Possible decryption with key ten: Aztli rwjq hzsumr doelsrg xgii gnz elsinc
Possible decryption with key tfn: Aytlh rvjq hzrumq dnelrrg xghi fnz elrinb
Possible decryption with key tgn: Axtlg rujq hzqump dmelqrg xggi enz elqina
Possible decryption with key thi: Awylf rtoq mzpzmo dljlpwg cgfn dsz jlpnnz
Possible decryption with key thn: Awtlf rtjq hzpumo dlelprg xgfi dnz elpinz
Possible decryption with key tic: Avele rsuq szofmn dkplocg iget cyz plotny
Possible decryption with key tin: Avtle rsjq hzoumn dkelorg xgei cnz eloiny
Possible decryption with key tiq: Avqle rsgq ezormn dkbloog ugef ckz blofny
Possible decryption with key tiz: Avhle rsxq vzoimn dkslofg lgew cbz slowny
Possible decryption with key tjn: Autld rrjq hznumm djelnrg xgdi bnz elninx
Possible decryption with key tke: Atclc rqsq qzmdml dinlmag ggcr awz nlmrnw
Possible decryption with key tkn: Attlc rqjq hzmuml dielmrg xgci anz elminw
Possible decryption with key tks: Atolc rqeq czmpml dizlmmg sgcd aiz zlmdnw
Possible decryption with key tkz: Athlc rqxq vzmiml dislmfg lgcw abz slmwnw
Possible decryption with key tln: Astlb rpjq hzlumk dhellrg xgbi znz ellinv
Possible decryption with key tmn: Artla rojq hzkumj dgelkrg xgai ynz elkinu
Possible decryption with key tmr: Arpla rofq dzkqmj dgalkng tgae yjz alkenu
Possible decryption with key tnn: Aqtlz rnjq hzjumi dfeljrg xgzi xnz eljint
Possible decryption with key tod: Apdly rmtq rziemh deolibg hgys wxz olisns
Possible decryption with key toi: Apyly rmoq mzizmh dejliwg cgyn wsz jlinns
Possible decryption with key tom: Apuly rmkq izivmh deflisg ygyj woz flijns
Possible decryption with key ton: Aptly rmjq hziumh deelirg xgyi wnz eliins
Possible decryption with key top: Aprly rmhq fzismh declipg vgyg wlz cligns
Possible decryption with key tor: Apply rmfq dziqmh dealing tgye wjz aliens
Possible decryption with key tou: Apmly rmcq azinmh dexlikg qgyb wgz xlibns
Possible decryption with key tpb: Aoflx rlvq tzhgmg ddqlhdg jgxu vzz qlhunr
Possible decryption with key tpn: Aotlx rljq hzhumg ddelhrg xgxi vnz elhinr
Possible decryption with key tqd: Andlw rktq rzgemf dcolgbg hgws uxz olgsnq
Possible decryption with key tqn: Antlw rkjq hzgumf dcelgrg xgwi unz elginq
Possible decryption with key trm: Amulv rjkq izfvme dbflfsg ygvj toz flfjnp
Possible decryption with key trn: Amtlv rjjq hzfume dbelfrg xgvi tnz elfinp
Possible decryption with key tse: Alclu risq qzedmd danleag ggur swz nlerno
Possible decryption with key tsj: Alxlu rinq lzeymd dailevg bgum srz ilemno
Possible decryption with key tsn: Altlu rijq hzeumd daelerg xgui snz eleino
Possible decryption with key tth: Akzlt rhpq nzdamc dzkldxg dgto rtz kldonn
Possible decryption with key ttn: Aktlt rhjq hzdumc dzeldrg xgti rnz eldinn
Possible decryption with key tun: Ajtls rgjq hzcumb dyelcrg xgsi qnz elcinm
Possible decryption with key tvn: Aitlr rfjq hzbuma dxelbrg xgri pnz elbinl
Possible decryption with key tvo: Aislr rfiq gzbtma dxdlbqg wgrh pmz dlbhnl
Possible decryption with key tvt: Ainlr rfdq bzboma dxylblg rgrc phz ylbcnl
Possible decryption with key twn: Ahtlq rejq hzaumz dwelarg xgqi onz elaink
Possible decryption with key twv: Ahllq rebq zzammz dwwlajg pgqa ofz wlaank
Possible decryption with key txn: Agtlp rdjq hzzumy dvelzrg xgpi nnz elzinj
Possible decryption with key tyn: Aftlo rcjq hzyumx duelyrg xgoi mnz elyini
Possible decryption with key tyq: Afqlo rcgq ezyrmx dublyog ugof mkz blyfni
Possible decryption with key tzd: Aedln rbtq rzxemw dtolxbg hgns lxz olxsnh
Possible decryption with key tzn: Aetln rbjq hzxumw dtelxrg xgni lnz elxinh
Possible decryption with key uaq: Zdqkm qagp eywrlv csbkwof ufmf kky bkwfmg
Possible decryption with key uaw: Zdkkm qaap yywllv csvkwif ofmz key vkwzmg
Possible decryption with key ubq: Zcqkl qzgp eyvrlu crbkvof uflf jky bkvfmf
Possible decryption with key ubw: Zckkl qzap yyvllu crvkvif oflz jey vkvzmf
Possible decryption with key uci: Zbykk qyop myuzlt cqjkuwf cfkn isy jkunme
Possible decryption with key ucn: Zbtkk qyjp hyuult cqekurf xfki iny ekuime
Possible decryption with key ucq: Zbqkk qygp eyurlt cqbkuof ufkf iky bkufme
Possible decryption with key ucw: Zbkkk qyap yyullt cqvkuif ofkz iey vkuzme
Possible decryption with key udh: Zazkj qxpp nytals cpkktxf dfjo hty kktomd
Possible decryption with key udq: Zaqkj qxgp eytrls cpbktof ufjf hky bktfmd
Possible decryption with key udt: Zankj qxdp bytols cpyktlf rfjc hhy yktcmd
Possible decryption with key udw: Zakkj qxap yytlls cpvktif ofjz hey vktzmd
Possible decryption with key ued: Zzdki qwtp ryselr cooksbf hfis gxy okssmc
Possible decryption with key uei: Zzyki qwop myszlr cojkswf cfin gsy jksnmc
Possible decryption with key uem: Zzuki qwkp iysvlr cofkssf yfij goy fksjmc
Possible decryption with key ueq: Zzqki qwgp eysrlr cobksof ufif gky bksfmc
Possible decryption with key uew: Zzkki qwap yysllr covksif ofiz gey vkszmc
Possible decryption with key ufq: Zyqkh qvgp eyrrlq cnbkrof ufhf fky bkrfmb
Possible decryption with key ufw: Zykkh qvap yyrllq cnvkrif ofhz fey vkrzmb
Possible decryption with key ugq: Zxqkg qugp eyqrlp cmbkqof ufgf eky bkqfma
Possible decryption with key ugw: Zxkkg quap yyqllp cmvkqif ofgz eey vkqzma
Possible decryption with key uhi: Zwykf qtop mypzlo cljkpwf cffn dsy jkpnmz
Possible decryption with key uhq: Zwqkf qtgp eyprlo clbkpof ufff dky bkpfmz
Possible decryption with key uhw: Zwkkf qtap yypllo clvkpif offz dey vkpzmz
Possible decryption with key uic: Zveke qsup syofln ckpkocf ifet cyy pkotmy
Possible decryption with key uiq: Zvqke qsgp eyorln ckbkoof ufef cky bkofmy
Possible decryption with key uiw: Zvkke qsap yyolln ckvkoif ofez cey vkozmy
Possible decryption with key uiz: Zvhke qsxp vyoiln ckskoff lfew cby skowmy
Possible decryption with key ujq: Zuqkd qrgp eynrlm cjbknof ufdf bky bknfmx
Possible decryption with key ujw: Zukkd qrap yynllm cjvknif ofdz bey vknzmx
Possible decryption with key uke: Ztckc qqsp qymdll cinkmaf gfcr awy nkmrmw
Possible decryption with key ukq: Ztqkc qqgp eymrll cibkmof ufcf aky bkmfmw
Possible decryption with key uks: Ztokc qqep cympll cizkmmf sfcd aiy zkmdmw
Possible decryption with key ukw: Ztkkc qqap yymlll civkmif ofcz aey vkmzmw
Possible decryption with key ukz: Zthkc qqxp vymill ciskmff lfcw aby skmwmw
Possible decryption with key ulq: Zsqkb qpgp eylrlk chbklof ufbf zky bklfmv
Possible decryption with key ulw: Zskkb qpap yylllk chvklif ofbz zey vklzmv
Possible decryption with key umq: Zrqka qogp eykrlj cgbkkof ufaf yky bkkfmu
Possible decryption with key umr: Zrpka qofp dykqlj cgakknf tfae yjy akkemu
Possible decryption with key umw: Zrkka qoap yykllj cgvkkif ofaz yey vkkzmu
Possible decryption with key unq: Zqqkz qngp eyjrli cfbkjof ufzf xky bkjfmt
Possible decryption with key unw: Zqkkz qnap yyjlli cfvkjif ofzz xey vkjzmt
Possible decryption with key uod: Zpdky qmtp ryielh ceokibf hfys wxy okisms
Possible decryption with key uoi: Zpyky qmop myizlh cejkiwf cfyn wsy jkinms
Possible decryption with key uom: Zpuky qmkp iyivlh cefkisf yfyj woy fkijms
Possible decryption with key uop: Zprky qmhp fyislh ceckipf vfyg wly ckigms
Possible decryption with key uoq: Zpqky qmgp eyirlh cebkiof ufyf wky bkifms
Possible decryption with key uor: Zppky qmfp dyiqlh ceakinf tfye wjy akiems
Possible decryption with key uou: Zpmky qmcp ayinlh cexkikf qfyb wgy xkibms
Possible decryption with key uow: Zpkky qmap yyillh cevkiif ofyz wey vkizms
Possible decryption with key upb: Zofkx qlvp tyhglg cdqkhdf jfxu vzy qkhumr
Possible decryption with key upq: Zoqkx qlgp eyhrlg cdbkhof ufxf vky bkhfmr
Possible decryption with key upw: Zokkx qlap yyhllg cdvkhif ofxz vey vkhzmr
Possible decryption with key uqq: Znqkw qkgp eygrlf ccbkgof ufwf uky bkgfmq
Possible decryption with key uqw: Znkkw qkap yygllf ccvkgif ofwz uey vkgzmq
Possible decryption with key urm: Zmukv qjkp iyfvle cbfkfsf yfvj toy fkfjmp
Possible decryption with key urq: Zmqkv qjgp eyfrle cbbkfof ufvf tky bkffmp
Possible decryption with key urw: Zmkkv qjap yyflle cbvkfif ofvz tey vkfzmp
Possible decryption with key use: Zlcku qisp qyedld cankeaf gfur swy nkermo
Possible decryption with key usj: Zlxku qinp lyeyld caikevf bfum sry ikemmo
Possible decryption with key usq: Zlqku qigp eyerld cabkeof ufuf sky bkefmo
Possible decryption with key usw: Zlkku qiap yyelld cavkeif ofuz sey vkezmo
Possible decryption with key uth: Zkzkt qhpp nydalc czkkdxf dfto rty kkdomn
Possible decryption with key utq: Zkqkt qhgp eydrlc czbkdof uftf rky bkdfmn
Possible decryption with key utw: Zkkkt qhap yydllc czvkdif oftz rey vkdzmn
Possible decryption with key uuq: Zjqks qggp eycrlb cybkcof ufsf qky bkcfmm
Possible decryption with key uuw: Zjkks qgap yycllb cyvkcif ofsz qey vkczmm
Possible decryption with key uvo: Ziskr qfip gybtla cxdkbqf wfrh pmy dkbhml
Possible decryption with key uvq: Ziqkr qfgp eybrla cxbkbof ufrf pky bkbfml
Possible decryption with key uvt: Zinkr qfdp bybola cxykblf rfrc phy ykbcml
Possible decryption with key uvw: Zikkr qfap yyblla cxvkbif ofrz pey vkbzml
Possible decryption with key uwq: Zhqkq qegp eyarlz cwbkaof ufqf oky bkafmk
Possible decryption with key uwv: Zhlkq qebp zyamlz cwwkajf pfqa ofy wkaamk
Possible decryption with key uww: Zhkkq qeap yyallz cwvkaif ofqz oey vkazmk
Possible decryption with key uxq: Zgqkp qdgp eyzrly cvbkzof ufpf nky bkzfmj
Possible decryption with key uxw: Zgkkp qdap yyzlly cvvkzif ofpz ney vkzzmj
Possible decryption with key uyq: Zfqko qcgp eyyrlx cubkyof ufof mky bkyfmi
Possible decryption with key uyw: Zfkko qcap yyyllx cuvkyif ofoz mey vkyzmi
Possible decryption with key uzd: Zedkn qbtp ryxelw ctokxbf hfns lxy okxsmh
Possible decryption with key uzq: Zeqkn qbgp eyxrlw ctbkxof ufnf lky bkxfmh
Possible decryption with key uzw: Zekkn qbap yyxllw ctvkxif ofnz ley vkxzmh
Possible decryption with key vad: Yddjm pato rxwekv bsojwbe hems kxx ojwslg
Possible decryption with key vbd: Ycdjl pzto rxveku brojvbe hels jxx ojvslf
Possible decryption with key vcd: Ybdjk pyto rxuekt bqojube heks ixx ojusle
Possible decryption with key vci: Ybyjk pyoo mxuzkt bqjjuwe cekn isx jjunle
Possible decryption with key vcn: Ybtjk pyjo hxuukt bqejure xeki inx ejuile
Possible decryption with key vdd: Yadjj pxto rxteks bpojtbe hejs hxx ojtsld
Possible decryption with key vdh: Yazjj pxpo nxtaks bpkjtxe dejo htx kjtold
Possible decryption with key vdq: Yaqjj pxgo extrks bpbjtoe uejf hkx bjtfld
Possible decryption with key vdt: Yanjj pxdo bxtoks bpyjtle rejc hhx yjtcld
Possible decryption with key vdx: Yajjj pxzo xxtkks bpujthe nejy hdx ujtyld
Possible decryption with key ved: Yzdji pwto rxsekr boojsbe heis gxx ojsslc
Possible decryption with key vei: Yzyji pwoo mxszkr bojjswe cein gsx jjsnlc
Possible decryption with key vem: Yzuji pwko ixsvkr bofjsse yeij gox fjsjlc
Possible decryption with key vfd: Yydjh pvto rxrekq bnojrbe hehs fxx ojrslb
Possible decryption with key vgd: Yxdjg puto rxqekp bmojqbe hegs exx ojqsla
Possible decryption with key vhd: Ywdjf ptto rxpeko blojpbe hefs dxx ojpslz
Possible decryption with key vhi: Ywyjf ptoo mxpzko bljjpwe cefn dsx jjpnlz
Possible decryption with key vic: Yveje psuo sxofkn bkpjoce ieet cyx pjotly
Possible decryption with key vid: Yvdje psto rxoekn bkojobe hees cxx ojosly
Possible decryption with key viq: Yvqje psgo exorkn bkbjooe ueef ckx bjofly
Possible decryption with key viz: Yvhje psxo vxoikn bksjofe leew cbx sjowly
Possible decryption with key vjd: Yudjd prto rxnekm bjojnbe heds bxx ojnslx
Possible decryption with key vkd: Ytdjc pqto rxmekl biojmbe hecs axx ojmslw
Possible decryption with key vke: Ytcjc pqso qxmdkl binjmae gecr awx njmrlw
Possible decryption with key vks: Ytojc pqeo cxmpkl bizjmme secd aix zjmdlw
Possible decryption with key vkz: Ythjc pqxo vxmikl bisjmfe lecw abx sjmwlw
Possible decryption with key vld: Ysdjb ppto rxlekk bhojlbe hebs zxx ojlslv
Possible decryption with key vmd: Yrdja poto rxkekj bgojkbe heas yxx ojkslu
Possible decryption with key vmr: Yrpja pofo dxkqkj bgajkne teae yjx ajkelu
Possible decryption with key vnd: Yqdjz pnto rxjeki bfojjbe hezs xxx ojjslt
Possible decryption with key vod: Ypdjy pmto rxiekh beojibe heys wxx ojisls
Possible decryption with key voi: Ypyjy pmoo mxizkh bejjiwe ceyn wsx jjinls
Possible decryption with key vom: Ypujy pmko ixivkh befjise yeyj wox fjijls
Possible decryption with key vop: Yprjy pmho fxiskh becjipe veyg wlx cjigls
Possible decryption with key vor: Yppjy pmfo dxiqkh beajine teye wjx ajiels
Possible decryption with key vou: Ypmjy pmco axinkh bexjike qeyb wgx xjibls
Possible decryption with key vpb: Yofjx plvo txhgkg bdqjhde jexu vzx qjhulr
Possible decryption with key vpd: Yodjx plto rxhekg bdojhbe hexs vxx ojhslr
Possible decryption with key vqd: Yndjw pkto rxgekf bcojgbe hews uxx ojgslq
Possible decryption with key vrd: Ymdjv pjto rxfeke bbojfbe hevs txx ojfslp
Possible decryption with key vrm: Ymujv pjko ixfvke bbfjfse yevj tox fjfjlp
Possible decryption with key vsd: Yldju pito rxeekd baojebe heus sxx ojeslo
Possible decryption with key vse: Ylcju piso qxedkd banjeae geur swx njerlo
Possible decryption with key vsj: Ylxju pino lxeykd baijeve beum srx ijemlo
Possible decryption with key vtd: Ykdjt phto rxdekc bzojdbe hets rxx ojdsln
Possible decryption with key vth: Ykzjt phpo nxdakc bzkjdxe deto rtx kjdoln
Possible decryption with key vud: Yjdjs pgto rxcekb byojcbe hess qxx ojcslm
Possible decryption with key vvd: Yidjr pfto rxbeka bxojbbe hers pxx ojbsll
Possible decryption with key vvo: Yisjr pfio gxbtka bxdjbqe werh pmx djbhll
Possible decryption with key vvt: Yinjr pfdo bxboka bxyjble rerc phx yjbcll
Possible decryption with key vwd: Yhdjq peto rxaekz bwojabe heqs oxx ojaslk
Possible decryption with key vwv: Yhljq pebo zxamkz bwwjaje peqa ofx wjaalk
Possible decryption with key vxd: Ygdjp pdto rxzeky bvojzbe heps nxx ojzslj
Possible decryption with key vyd: Yfdjo pcto rxyekx buojybe heos mxx ojysli
Possible decryption with key vyq: Yfqjo pcgo exyrkx bubjyoe ueof mkx bjyfli
Possible decryption with key vzd: Yedjn pbto rxxekw btojxbe hens lxx ojxslh
Possible decryption with key wao: Xdsim oain gwwtjv asdiwqd wdmh kmw diwhkg
Possible decryption with key wbo: Xcsil ozin gwvtju ardivqd wdlh jmw divhkf
Possible decryption with key wci: Xbyik oyon mwuzjt aqjiuwd cdkn isw jiunke
Possible decryption with key wcn: Xbtik oyjn hwuujt aqeiurd xdki inw eiuike
Possible decryption with key wco: Xbsik oyin gwutjt aqdiuqd wdkh imw diuhke
Possible decryption with key wdh: Xazij oxpn nwtajs apkitxd ddjo htw kitokd
Possible decryption with key wdo: Xasij oxin gwttjs apditqd wdjh hmw dithkd
Possible decryption with key wdq: Xaqij oxgn ewtrjs apbitod udjf hkw bitfkd
Possible decryption with key wdt: Xanij oxdn bwtojs apyitld rdjc hhw yitckd
Possible decryption with key wea: Xzgii owwn uwshjr aorised kdiv gaw risvkc
Possible decryption with key web: Xzfii owvn twsgjr aoqisdd jdiu gzw qisukc
Possible decryption with key wec: Xzeii owun swsfjr aopiscd idit gyw pistkc
Possible decryption with key wed: Xzdii owtn rwsejr aooisbd hdis gxw oisskc
Possible decryption with key wee: Xzcii owsn qwsdjr aonisad gdir gww nisrkc
Possible decryption with key wef: Xzbii owrn pwscjr aomiszd fdiq gvw misqkc
Possible decryption with key weg: Xzaii owqn owsbjr aolisyd edip guw lispkc
Possible decryption with key weh: Xzzii owpn nwsajr aokisxd ddio gtw kisokc
Possible decryption with key wei: Xzyii owon mwszjr aojiswd cdin gsw jisnkc
Possible decryption with key wej: Xzxii ownn lwsyjr aoiisvd bdim grw iismkc
Possible decryption with key wek: Xzwii owmn kwsxjr aohisud adil gqw hislkc
Possible decryption with key wel: Xzvii owln jwswjr aogistd zdik gpw giskkc
Possible decryption with key wem: Xzuii owkn iwsvjr aofissd ydij gow fisjkc
Possible decryption with key wen: Xztii owjn hwsujr aoeisrd xdii gnw eisikc
Possible decryption with key weo: Xzsii owin gwstjr aodisqd wdih gmw dishkc
Possible decryption with key wep: Xzrii owhn fwssjr aocispd vdig glw cisgkc
Possible decryption with key weq: Xzqii owgn ewsrjr aobisod udif gkw bisfkc
Possible decryption with key wer: Xzpii owfn dwsqjr aoaisnd tdie gjw aisekc
Possible decryption with key wes: Xzoii owen cwspjr aozismd sdid giw zisdkc
Possible decryption with key wet: Xznii owdn bwsojr aoyisld rdic ghw yisckc
Possible decryption with key weu: Xzmii owcn awsnjr aoxiskd qdib ggw xisbkc
Possible decryption with key wev: Xzlii owbn zwsmjr aowisjd pdia gfw wisakc
Possible decryption with key wew: Xzkii owan ywsljr aovisid odiz gew viszkc
Possible decryption with key wex: Xzjii owzn xwskjr aouishd ndiy gdw uisykc
Possible decryption with key wey: Xziii owyn wwsjjr aotisgd mdix gcw tisxkc
Possible decryption with key wez: Xzhii owxn vwsijr aosisfd ldiw gbw siswkc
Possible decryption with key wfo: Xysih ovin gwrtjq andirqd wdhh fmw dirhkb
Possible decryption with key wgo: Xxsig ouin gwqtjp amdiqqd wdgh emw diqhka
Possible decryption with key whi: Xwyif oton mwpzjo aljipwd cdfn dsw jipnkz
Possible decryption with key who: Xwsif otin gwptjo aldipqd wdfh dmw diphkz
Possible decryption with key wic: Xveie osun swofjn akpiocd idet cyw piotky
Possible decryption with key wio: Xvsie osin gwotjn akdioqd wdeh cmw diohky
Possible decryption with key wiq: Xvqie osgn eworjn akbiood udef ckw biofky
Possible decryption with key wiz: Xvhie osxn vwoijn aksiofd ldew cbw siowky
Possible decryption with key wja: Xugid orwn uwnhjm ajrined kddv baw rinvkx
Possible decryption with key wjb: Xufid orvn twngjm ajqindd jddu bzw qinukx
Possible decryption with key wjc: Xueid orun swnfjm ajpincd iddt byw pintkx
Possible decryption with key wjd: Xudid ortn rwnejm ajoinbd hdds bxw oinskx
Possible decryption with key wje: Xucid orsn qwndjm ajninad gddr bww ninrkx
Possible decryption with key wjf: Xubid orrn pwncjm ajminzd fddq bvw minqkx
Possible decryption with key wjg: Xuaid orqn ownbjm ajlinyd eddp buw linpkx
Possible decryption with key wjh: Xuzid orpn nwnajm ajkinxd dddo btw kinokx
Possible decryption with key wji: Xuyid oron mwnzjm ajjinwd cddn bsw jinnkx
Possible decryption with key wjj: Xuxid ornn lwnyjm ajiinvd bddm brw iinmkx
Possible decryption with key wjk: Xuwid ormn kwnxjm ajhinud addl bqw hinlkx
Possible decryption with key wjl: Xuvid orln jwnwjm ajgintd zddk bpw ginkkx
Possible decryption with key wjm: Xuuid orkn iwnvjm ajfinsd yddj bow finjkx
Possible decryption with key wjn: Xutid orjn hwnujm ajeinrd xddi bnw einikx
Possible decryption with key wjo: Xusid orin gwntjm ajdinqd wddh bmw dinhkx
Possible decryption with key wjp: Xurid orhn fwnsjm ajcinpd vddg blw cingkx
Possible decryption with key wjq: Xuqid orgn ewnrjm ajbinod uddf bkw binfkx
Possible decryption with key wjr: Xupid orfn dwnqjm ajainnd tdde bjw ainekx
Possible decryption with key wjs: Xuoid oren cwnpjm ajzinmd sddd biw zindkx
Possible decryption with key wjt: Xunid ordn bwnojm ajyinld rddc bhw yinckx
Possible decryption with key wju: Xumid orcn awnnjm ajxinkd qddb bgw xinbkx
Possible decryption with key wjv: Xulid orbn zwnmjm ajwinjd pdda bfw winakx
Possible decryption with key wjw: Xukid oran ywnljm ajvinid oddz bew vinzkx
Possible decryption with key wjx: Xujid orzn xwnkjm ajuinhd nddy bdw uinykx
Possible decryption with key wjy: Xuiid oryn wwnjjm ajtingd mddx bcw tinxkx
Possible decryption with key wjz: Xuhid orxn vwnijm ajsinfd lddw bbw sinwkx
Possible decryption with key wke: Xtcic oqsn qwmdjl ainimad gdcr aww nimrkw
Possible decryption with key wko: Xtsic oqin gwmtjl aidimqd wdch amw dimhkw
Possible decryption with key wks: Xtoic oqen cwmpjl aizimmd sdcd aiw zimdkw
Possible decryption with key wkz: Xthic oqxn vwmijl aisimfd ldcw abw simwkw
Possible decryption with key wlo: Xssib opin gwltjk ahdilqd wdbh zmw dilhkv
Possible decryption with key wmo: Xrsia ooin gwktjj agdikqd wdah ymw dikhku
Possible decryption with key wmr: Xrpia oofn dwkqjj agaiknd tdae yjw aikeku
Possible decryption with key wno: Xqsiz onin gwjtji afdijqd wdzh xmw dijhkt
Possible decryption with key wod: Xpdiy omtn rwiejh aeoiibd hdys wxw oiisks
Possible decryption with key woi: Xpyiy omon mwizjh aejiiwd cdyn wsw jiinks
Possible decryption with key wom: Xpuiy omkn iwivjh aefiisd ydyj wow fiijks
Possible decryption with key woo: Xpsiy omin gwitjh aediiqd wdyh wmw diihks
Possible decryption with key wop: Xpriy omhn fwisjh aeciipd vdyg wlw ciigks
Possible decryption with key wor: Xppiy omfn dwiqjh aeaiind tdye wjw aiieks
Possible decryption with key wou: Xpmiy omcn awinjh aexiikd qdyb wgw xiibks
Possible decryption with key wpb: Xofix olvn twhgjg adqihdd jdxu vzw qihukr
Possible decryption with key wpo: Xosix olin gwhtjg addihqd wdxh vmw dihhkr
Possible decryption with key wqo: Xnsiw okin gwgtjf acdigqd wdwh umw dighkq
Possible decryption with key wrm: Xmuiv ojkn iwfvje abfifsd ydvj tow fifjkp
Possible decryption with key wro: Xmsiv ojin gwftje abdifqd wdvh tmw difhkp
Possible decryption with key wse: Xlciu oisn qwedjd aaniead gdur sww nierko
Possible decryption with key wsj: Xlxiu oinn lweyjd aaiievd bdum srw iiemko
Possible decryption with key wso: Xlsiu oiin gwetjd aadieqd wduh smw diehko
Possible decryption with key wth: Xkzit ohpn nwdajc azkidxd ddto rtw kidokn
Possible decryption with key wto: Xksit ohin gwdtjc azdidqd wdth rmw didhkn
Possible decryption with key wua: Xjgis ogwn uwchjb ayriced kdsv qaw ricvkm
Possible decryption with key wub: Xjfis ogvn twcgjb ayqicdd jdsu qzw qicukm
Possible decryption with key wuc: Xjeis ogun swcfjb aypiccd idst qyw pictkm
Possible decryption with key wud: Xjdis ogtn rwcejb ayoicbd hdss qxw oicskm
Possible decryption with key wue: Xjcis ogsn qwcdjb aynicad gdsr qww nicrkm
Possible decryption with key wuf: Xjbis ogrn pwccjb aymiczd fdsq qvw micqkm
Possible decryption with key wug: Xjais ogqn owcbjb aylicyd edsp quw licpkm
Possible decryption with key wuh: Xjzis ogpn nwcajb aykicxd ddso qtw kicokm
Possible decryption with key wui: Xjyis ogon mwczjb ayjicwd cdsn qsw jicnkm
Possible decryption with key wuj: Xjxis ognn lwcyjb ayiicvd bdsm qrw iicmkm
Possible decryption with key wuk: Xjwis ogmn kwcxjb ayhicud adsl qqw hiclkm
Possible decryption with key wul: Xjvis ogln jwcwjb aygictd zdsk qpw gickkm
Possible decryption with key wum: Xjuis ogkn iwcvjb ayficsd ydsj qow ficjkm
Possible decryption with key wun: Xjtis ogjn hwcujb ayeicrd xdsi qnw eicikm
Possible decryption with key wuo: Xjsis ogin gwctjb aydicqd wdsh qmw dichkm
Possible decryption with key wup: Xjris oghn fwcsjb aycicpd vdsg qlw cicgkm
Possible decryption with key wuq: Xjqis oggn ewcrjb aybicod udsf qkw bicfkm
Possible decryption with key wur: Xjpis ogfn dwcqjb ayaicnd tdse qjw aicekm
Possible decryption with key wus: Xjois ogen cwcpjb ayzicmd sdsd qiw zicdkm
Possible decryption with key wut: Xjnis ogdn bwcojb ayyicld rdsc qhw yicckm
Possible decryption with key wuu: Xjmis ogcn awcnjb ayxickd qdsb qgw xicbkm
Possible decryption with key wuv: Xjlis ogbn zwcmjb aywicjd pdsa qfw wicakm
Possible decryption with key wuw: Xjkis ogan ywcljb ayvicid odsz qew viczkm
Possible decryption with key wux: Xjjis ogzn xwckjb ayuichd ndsy qdw uicykm
Possible decryption with key wuy: Xjiis ogyn wwcjjb ayticgd mdsx qcw ticxkm
Possible decryption with key wuz: Xjhis ogxn vwcijb aysicfd ldsw qbw sicwkm
Possible decryption with key wva: Xigir ofwn uwbhja axribed kdrv paw ribvkl
Possible decryption with key wvb: Xifir ofvn twbgja axqibdd jdru pzw qibukl
Possible decryption with key wvc: Xieir ofun swbfja axpibcd idrt pyw pibtkl
Possible decryption with key wvd: Xidir oftn rwbeja axoibbd hdrs pxw oibskl
Possible decryption with key wve: Xicir ofsn qwbdja axnibad gdrr pww nibrkl
Possible decryption with key wvf: Xibir ofrn pwbcja axmibzd fdrq pvw mibqkl
Possible decryption with key wvg: Xiair ofqn owbbja axlibyd edrp puw libpkl
Possible decryption with key wvh: Xizir ofpn nwbaja axkibxd ddro ptw kibokl
Possible decryption with key wvi: Xiyir ofon mwbzja axjibwd cdrn psw jibnkl
Possible decryption with key wvj: Xixir ofnn lwbyja axiibvd bdrm prw iibmkl
Possible decryption with key wvk: Xiwir ofmn kwbxja axhibud adrl pqw hiblkl
Possible decryption with key wvl: Xivir ofln jwbwja axgibtd zdrk ppw gibkkl
Possible decryption with key wvm: Xiuir ofkn iwbvja axfibsd ydrj pow fibjkl
Possible decryption with key wvn: Xitir ofjn hwbuja axeibrd xdri pnw eibikl
Possible decryption with key wvo: Xisir ofin gwbtja axdibqd wdrh pmw dibhkl
Possible decryption with key wvp: Xirir ofhn fwbsja axcibpd vdrg plw cibgkl
Possible decryption with key wvq: Xiqir ofgn ewbrja axbibod udrf pkw bibfkl
Possible decryption with key wvr: Xipir offn dwbqja axaibnd tdre pjw aibekl
Possible decryption with key wvs: Xioir ofen cwbpja axzibmd sdrd piw zibdkl
Possible decryption with key wvt: Xinir ofdn bwboja axyibld rdrc phw yibckl
Possible decryption with key wvu: Ximir ofcn awbnja axxibkd qdrb pgw xibbkl
Possible decryption with key wvv: Xilir ofbn zwbmja axwibjd pdra pfw wibakl
Possible decryption with key wvw: Xikir ofan ywblja axvibid odrz pew vibzkl
Possible decryption with key wvx: Xijir ofzn xwbkja axuibhd ndry pdw uibykl
Possible decryption with key wvy: Xiiir ofyn wwbjja axtibgd mdrx pcw tibxkl
Possible decryption with key wvz: Xihir ofxn vwbija axsibfd ldrw pbw sibwkl
Possible decryption with key wwo: Xhsiq oein gwatjz awdiaqd wdqh omw diahkk
Possible decryption with key wwr: Xhpiq oefn dwaqjz awaiand tdqe ojw aiaekk
Possible decryption with key wwv: Xhliq oebn zwamjz awwiajd pdqa ofw wiaakk
Possible decryption with key wxo: Xgsip odin gwztjy avdizqd wdph nmw dizhkj
Possible decryption with key wyo: Xfsio ocin gwytjx audiyqd wdoh mmw diyhki
Possible decryption with key wyq: Xfqio ocgn ewyrjx aubiyod udof mkw biyfki
Possible decryption with key wza: Xegin obwn uwxhjw atrixed kdnv law rixvkh
Possible decryption with key wzb: Xefin obvn twxgjw atqixdd jdnu lzw qixukh
Possible decryption with key wzc: Xeein obun swxfjw atpixcd idnt lyw pixtkh
Possible decryption with key wzd: Xedin obtn rwxejw atoixbd hdns lxw oixskh
Possible decryption with key wze: Xecin obsn qwxdjw atnixad gdnr lww nixrkh
Possible decryption with key wzf: Xebin obrn pwxcjw atmixzd fdnq lvw mixqkh
Possible decryption with key wzg: Xeain obqn owxbjw atlixyd ednp luw lixpkh
Possible decryption with key wzh: Xezin obpn nwxajw atkixxd ddno ltw kixokh
Possible decryption with key wzi: Xeyin obon mwxzjw atjixwd cdnn lsw jixnkh
Possible decryption with key wzj: Xexin obnn lwxyjw atiixvd bdnm lrw iixmkh
Possible decryption with key wzk: Xewin obmn kwxxjw athixud adnl lqw hixlkh
Possible decryption with key wzl: Xevin obln jwxwjw atgixtd zdnk lpw gixkkh
Possible decryption with key wzm: Xeuin obkn iwxvjw atfixsd ydnj low fixjkh
Possible decryption with key wzn: Xetin objn hwxujw ateixrd xdni lnw eixikh
Possible decryption with key wzo: Xesin obin gwxtjw atdixqd wdnh lmw dixhkh
Possible decryption with key wzp: Xerin obhn fwxsjw atcixpd vdng llw cixgkh
Possible decryption with key wzq: Xeqin obgn ewxrjw atbixod udnf lkw bixfkh
Possible decryption with key wzr: Xepin obfn dwxqjw ataixnd tdne ljw aixekh
Possible decryption with key wzs: Xeoin oben cwxpjw atzixmd sdnd liw zixdkh
Possible decryption with key wzt: Xenin obdn bwxojw atyixld rdnc lhw yixckh
Possible decryption with key wzu: Xemin obcn awxnjw atxixkd qdnb lgw xixbkh
Possible decryption with key wzv: Xelin obbn zwxmjw atwixjd pdna lfw wixakh
Possible decryption with key wzw: Xekin oban ywxljw atvixid odnz lew vixzkh
Possible decryption with key wzx: Xejin obzn xwxkjw atuixhd ndny ldw uixykh
Possible decryption with key wzy: Xeiin obyn wwxjjw attixgd mdnx lcw tixxkh
Possible decryption with key wzz: Xehin obxn vwxijw atsixfd ldnw lbw sixwkh
Possible decryption with key xci: Wbyhk nyom mvuzit zqjhuwc cckn isv jhunje
Possible decryption with key xcn: Wbthk nyjm hvuuit zqehurc xcki inv ehuije
Possible decryption with key xda: Waghj nxwm uvthis zprhtec kcjv hav rhtvjd
Possible decryption with key xdb: Wafhj nxvm tvtgis zpqhtdc jcju hzv qhtujd
Possible decryption with key xdc: Waehj nxum svtfis zpphtcc icjt hyv phttjd
Possible decryption with key xdd: Wadhj nxtm rvteis zpohtbc hcjs hxv ohtsjd
Possible decryption with key xde: Wachj nxsm qvtdis zpnhtac gcjr hwv nhtrjd
Possible decryption with key xdf: Wabhj nxrm pvtcis zpmhtzc fcjq hvv mhtqjd
Possible decryption with key xdg: Waahj nxqm ovtbis zplhtyc ecjp huv lhtpjd
Possible decryption with key xdh: Wazhj nxpm nvtais zpkhtxc dcjo htv khtojd
Possible decryption with key xdi: Wayhj nxom mvtzis zpjhtwc ccjn hsv jhtnjd
Possible decryption with key xdj: Waxhj nxnm lvtyis zpihtvc bcjm hrv ihtmjd
Possible decryption with key xdk: Wawhj nxmm kvtxis zphhtuc acjl hqv hhtljd
Possible decryption with key xdl: Wavhj nxlm jvtwis zpghttc zcjk hpv ghtkjd
Possible decryption with key xdm: Wauhj nxkm ivtvis zpfhtsc ycjj hov fhtjjd
Possible decryption with key xdn: Wathj nxjm hvtuis zpehtrc xcji hnv ehtijd
Possible decryption with key xdo: Washj nxim gvttis zpdhtqc wcjh hmv dhthjd
Possible decryption with key xdp: Warhj nxhm fvtsis zpchtpc vcjg hlv chtgjd
Possible decryption with key xdq: Waqhj nxgm evtris zpbhtoc ucjf hkv bhtfjd
Possible decryption with key xdr: Waphj nxfm dvtqis zpahtnc tcje hjv ahtejd
Possible decryption with key xds: Waohj nxem cvtpis zpzhtmc scjd hiv zhtdjd
Possible decryption with key xdt: Wanhj nxdm bvtois zpyhtlc rcjc hhv yhtcjd
Possible decryption with key xdu: Wamhj nxcm avtnis zpxhtkc qcjb hgv xhtbjd
Possible decryption with key xdv: Walhj nxbm zvtmis zpwhtjc pcja hfv whtajd
Possible decryption with key xdw: Wakhj nxam yvtlis zpvhtic ocjz hev vhtzjd
Possible decryption with key xdx: Wajhj nxzm xvtkis zpuhthc ncjy hdv uhtyjd
Possible decryption with key xdy: Waihj nxym wvtjis zpthtgc mcjx hcv thtxjd
Possible decryption with key xdz: Wahhj nxxm vvtiis zpshtfc lcjw hbv shtwjd
Possible decryption with key xed: Wzdhi nwtm rvseir zoohsbc hcis gxv ohssjc
Possible decryption with key xei: Wzyhi nwom mvszir zojhswc ccin gsv jhsnjc
Possible decryption with key xem: Wzuhi nwkm ivsvir zofhssc ycij gov fhsjjc
Possible decryption with key xhi: Wwyhf ntom mvpzio zljhpwc ccfn dsv jhpnjz
Possible decryption with key xia: Wvghe nswm uvohin zkrhoec kcev cav rhovjy
Possible decryption with key xib: Wvfhe nsvm tvogin zkqhodc jceu czv qhoujy
Possible decryption with key xic: Wvehe nsum svofin zkphocc icet cyv photjy
Possible decryption with key xid: Wvdhe nstm rvoein zkohobc hces cxv ohosjy
Possible decryption with key xie: Wvche nssm qvodin zknhoac gcer cwv nhorjy
Possible decryption with key xif: Wvbhe nsrm pvocin zkmhozc fceq cvv mhoqjy
Possible decryption with key xig: Wvahe nsqm ovobin zklhoyc ecep cuv lhopjy
Possible decryption with key xih: Wvzhe nspm nvoain zkkhoxc dceo ctv khoojy
Possible decryption with key xii: Wvyhe nsom mvozin zkjhowc ccen csv jhonjy
Possible decryption with key xij: Wvxhe nsnm lvoyin zkihovc bcem crv ihomjy
Possible decryption with key xik: Wvwhe nsmm kvoxin zkhhouc acel cqv hholjy
Possible decryption with key xil: Wvvhe nslm jvowin zkghotc zcek cpv ghokjy
Possible decryption with key xim: Wvuhe nskm ivovin zkfhosc ycej cov fhojjy
Possible decryption with key xin: Wvthe nsjm hvouin zkehorc xcei cnv ehoijy
Possible decryption with key xio: Wvshe nsim gvotin zkdhoqc wceh cmv dhohjy
Possible decryption with key xip: Wvrhe nshm fvosin zkchopc vceg clv chogjy
Possible decryption with key xiq: Wvqhe nsgm evorin zkbhooc ucef ckv bhofjy
Possible decryption with key xir: Wvphe nsfm dvoqin zkahonc tcee cjv ahoejy
Possible decryption with key xis: Wvohe nsem cvopin zkzhomc sced civ zhodjy
Possible decryption with key xit: Wvnhe nsdm bvooin zkyholc rcec chv yhocjy
Possible decryption with key xiu: Wvmhe nscm avonin zkxhokc qceb cgv xhobjy
Possible decryption with key xiv: Wvlhe nsbm zvomin zkwhojc pcea cfv whoajy
Possible decryption with key xiw: Wvkhe nsam yvolin zkvhoic ocez cev vhozjy
Possible decryption with key xix: Wvjhe nszm xvokin zkuhohc ncey cdv uhoyjy
Possible decryption with key xiy: Wvihe nsym wvojin zkthogc mcex ccv thoxjy
Possible decryption with key xiz: Wvhhe nsxm vvoiin zkshofc lcew cbv showjy
Possible decryption with key xke: Wtchc nqsm qvmdil zinhmac gccr awv nhmrjw
Possible decryption with key xks: Wtohc nqem cvmpil zizhmmc sccd aiv zhmdjw
Possible decryption with key xkz: Wthhc nqxm vvmiil zishmfc lccw abv shmwjw
Possible decryption with key xmr: Wrpha nofm dvkqij zgahknc tcae yjv ahkeju
Possible decryption with key xod: Wpdhy nmtm rvieih zeohibc hcys wxv ohisjs
Possible decryption with key xoi: Wpyhy nmom mvizih zejhiwc ccyn wsv jhinjs
Possible decryption with key xom: Wpuhy nmkm ivivih zefhisc ycyj wov fhijjs
Possible decryption with key xop: Wprhy nmhm fvisih zechipc vcyg wlv chigjs
Possible decryption with key xor: Wpphy nmfm dviqih zeahinc tcye wjv ahiejs
Possible decryption with key xou: Wpmhy nmcm avinih zexhikc qcyb wgv xhibjs
Possible decryption with key xpb: Wofhx nlvm tvhgig zdqhhdc jcxu vzv qhhujr
Possible decryption with key xrm: Wmuhv njkm ivfvie zbfhfsc ycvj tov fhfjjp
Possible decryption with key xse: Wlchu nism qvedid zanheac gcur swv nherjo
Possible decryption with key xsj: Wlxhu ninm lveyid zaihevc bcum srv ihemjo
Possible decryption with key xsy: Wlihu niym wvejid zathegc mcux scv thexjo
Possible decryption with key xth: Wkzht nhpm nvdaic zzkhdxc dcto rtv khdojn
Possible decryption with key xvo: Wishr nfim gvbtia zxdhbqc wcrh pmv dhbhjl
Possible decryption with key xvt: Winhr nfdm bvboia zxyhblc rcrc phv yhbcjl
Possible decryption with key xwv: Whlhq nebm zvamiz zwwhajc pcqa ofv whaajk
Possible decryption with key xyq: Wfqho ncgm evyrix zubhyoc ucof mkv bhyfji
Possible decryption with key xzd: Wedhn nbtm rvxeiw ztohxbc hcns lxv ohxsjh
Possible decryption with key yci: Vbygk myol muuzht yqjguwb cbkn isu jgunie
Possible decryption with key ycn: Vbtgk myjl huuuht yqegurb xbki inu eguiie
Possible decryption with key ydh: Vazgj mxpl nutahs ypkgtxb dbjo htu kgtoid
Possible decryption with key ydq: Vaqgj mxgl eutrhs ypbgtob ubjf hku bgtfid
Possible decryption with key ydt: Vangj mxdl butohs ypygtlb rbjc hhu ygtcid
Possible decryption with key yed: Vzdgi mwtl rusehr yoogsbb hbis gxu ogssic
Possible decryption with key yei: Vzygi mwol muszhr yojgswb cbin gsu jgsnic
Possible decryption with key yem: Vzugi mwkl iusvhr yofgssb ybij gou fgsjic
Possible decryption with key yhi: Vwygf mtol mupzho yljgpwb cbfn dsu jgpniz
Possible decryption with key yic: Vvege msul suofhn ykpgocb ibet cyu pgotiy
Possible decryption with key yiq: Vvqge msgl euorhn ykbgoob ubef cku bgofiy
Possible decryption with key yiz: Vvhge msxl vuoihn yksgofb lbew cbu sgowiy
Possible decryption with key yke: Vtcgc mqsl qumdhl yingmab gbcr awu ngmriw
Possible decryption with key yks: Vtogc mqel cumphl yizgmmb sbcd aiu zgmdiw
Possible decryption with key ykz: Vthgc mqxl vumihl yisgmfb lbcw abu sgmwiw
Possible decryption with key ymr: Vrpga mofl dukqhj ygagknb tbae yju agkeiu
Possible decryption with key yoa: Vpggy mmwl uuihhh yergieb kbyv wau rgivis
Possible decryption with key yob: Vpfgy mmvl tuighh yeqgidb jbyu wzu qgiuis
Possible decryption with key yoc: Vpegy mmul suifhh yepgicb ibyt wyu pgitis
Possible decryption with key yod: Vpdgy mmtl ruiehh yeogibb hbys wxu ogisis
Possible decryption with key yoe: Vpcgy mmsl quidhh yengiab gbyr wwu ngiris
Possible decryption with key yof: Vpbgy mmrl puichh yemgizb fbyq wvu mgiqis
Possible decryption with key yog: Vpagy mmql ouibhh yelgiyb ebyp wuu lgipis
Possible decryption with key yoh: Vpzgy mmpl nuiahh yekgixb dbyo wtu kgiois
Possible decryption with key yoi: Vpygy mmol muizhh yejgiwb cbyn wsu jginis
Possible decryption with key yoj: Vpxgy mmnl luiyhh yeigivb bbym wru igimis
Possible decryption with key yok: Vpwgy mmml kuixhh yehgiub abyl wqu hgilis
Possible decryption with key yol: Vpvgy mmll juiwhh yeggitb zbyk wpu ggikis
Possible decryption with key yom: Vpugy mmkl iuivhh yefgisb ybyj wou fgijis
Possible decryption with key yon: Vptgy mmjl huiuhh yeegirb xbyi wnu egiiis
Possible decryption with key yoo: Vpsgy mmil guithh yedgiqb wbyh wmu dgihis
Possible decryption with key yop: Vprgy mmhl fuishh yecgipb vbyg wlu cgigis
Possible decryption with key yoq: Vpqgy mmgl euirhh yebgiob ubyf wku bgifis
Possible decryption with key yor: Vppgy mmfl duiqhh yeaginb tbye wju agieis
Possible decryption with key yos: Vpogy mmel cuiphh yezgimb sbyd wiu zgidis
Possible decryption with key yot: Vpngy mmdl buiohh yeygilb rbyc whu ygicis
Possible decryption with key you: Vpmgy mmcl auinhh yexgikb qbyb wgu xgibis
Possible decryption with key yov: Vplgy mmbl zuimhh yewgijb pbya wfu wgiais
Possible decryption with key yow: Vpkgy mmal yuilhh yevgiib obyz weu vgizis
Possible decryption with key yox: Vpjgy mmzl xuikhh yeugihb nbyy wdu ugiyis
Possible decryption with key yoy: Vpigy mmyl wuijhh yetgigb mbyx wcu tgixis
Possible decryption with key yoz: Vphgy mmxl vuiihh yesgifb lbyw wbu sgiwis
Possible decryption with key ypb: Vofgx mlvl tuhghg ydqghdb jbxu vzu qghuir
Possible decryption with key yrm: Vmugv mjkl iufvhe ybfgfsb ybvj tou fgfjip
Possible decryption with key yro: Vmsgv mjil gufthe ybdgfqb wbvh tmu dgfhip
Possible decryption with key yse: Vlcgu misl quedhd yangeab gbur swu ngerio
Possible decryption with key ysj: Vlxgu minl lueyhd yaigevb bbum sru igemio
Possible decryption with key yta: Vkggt mhwl uudhhc yzrgdeb kbtv rau rgdvin
Possible decryption with key ytb: Vkfgt mhvl tudghc yzqgddb jbtu rzu qgduin
Possible decryption with key ytc: Vkegt mhul sudfhc yzpgdcb ibtt ryu pgdtin
Possible decryption with key ytd: Vkdgt mhtl rudehc yzogdbb hbts rxu ogdsin
Possible decryption with key yte: Vkcgt mhsl quddhc yzngdab gbtr rwu ngdrin
Possible decryption with key ytf: Vkbgt mhrl pudchc yzmgdzb fbtq rvu mgdqin
Possible decryption with key ytg: Vkagt mhql oudbhc yzlgdyb ebtp ruu lgdpin
Possible decryption with key yth: Vkzgt mhpl nudahc yzkgdxb dbto rtu kgdoin
Possible decryption with key yti: Vkygt mhol mudzhc yzjgdwb cbtn rsu jgdnin
Possible decryption with key ytj: Vkxgt mhnl ludyhc yzigdvb bbtm rru igdmin
Possible decryption with key ytk: Vkwgt mhml kudxhc yzhgdub abtl rqu hgdlin
Possible decryption with key ytl: Vkvgt mhll judwhc yzggdtb zbtk rpu ggdkin
Possible decryption with key ytm: Vkugt mhkl iudvhc yzfgdsb ybtj rou fgdjin
Possible decryption with key ytn: Vktgt mhjl huduhc yzegdrb xbti rnu egdiin
Possible decryption with key yto: Vksgt mhil gudthc yzdgdqb wbth rmu dgdhin
Possible decryption with key ytp: Vkrgt mhhl fudshc yzcgdpb vbtg rlu cgdgin
Possible decryption with key ytq: Vkqgt mhgl eudrhc yzbgdob ubtf rku bgdfin
Possible decryption with key ytr: Vkpgt mhfl dudqhc yzagdnb tbte rju agdein
Possible decryption with key yts: Vkogt mhel cudphc yzzgdmb sbtd riu zgddin
Possible decryption with key ytt: Vkngt mhdl budohc yzygdlb rbtc rhu ygdcin
Possible decryption with key ytu: Vkmgt mhcl audnhc yzxgdkb qbtb rgu xgdbin
Possible decryption with key ytv: Vklgt mhbl zudmhc yzwgdjb pbta rfu wgdain
Possible decryption with key ytw: Vkkgt mhal yudlhc yzvgdib obtz reu vgdzin
Possible decryption with key ytx: Vkjgt mhzl xudkhc yzugdhb nbty rdu ugdyin
Possible decryption with key yty: Vkigt mhyl wudjhc yztgdgb mbtx rcu tgdxin
Possible decryption with key ytz: Vkhgt mhxl vudihc yzsgdfb lbtw rbu sgdwin
Possible decryption with key yvo: Visgr mfil gubtha yxdgbqb wbrh pmu dgbhil
Possible decryption with key yvt: Vingr mfdl buboha yxygblb rbrc phu ygbcil
Possible decryption with key ywv: Vhlgq mebl zuamhz ywwgajb pbqa ofu wgaaik
Possible decryption with key yyq: Vfqgo mcgl euyrhx yubgyob ubof mku bgyfii
Possible decryption with key yzd: Vedgn mbtl ruxehw ytogxbb hbns lxu ogxsih
Possible decryption with key zad: Uddfm latk rtwegv xsofwba hams kxt ofwshg
Possible decryption with key zas: Udofm laek ctwpgv xszfwma samd kit zfwdhg
Possible decryption with key zbd: Ucdfl lztk rtvegu xrofvba hals jxt ofvshf
Possible decryption with key zbs: Ucofl lzek ctvpgu xrzfvma sald jit zfvdhf
Possible decryption with key zcc: Ubefk lyuk stufgt xqpfuca iakt iyt pfuthe
Possible decryption with key zcd: Ubdfk lytk rtuegt xqofuba haks ixt ofushe
Possible decryption with key zci: Ubyfk lyok mtuzgt xqjfuwa cakn ist jfunhe
Possible decryption with key zcn: Ubtfk lyjk htuugt xqefura xaki int efuihe
Possible decryption with key zcs: Ubofk lyek ctupgt xqzfuma sakd iit zfudhe
Possible decryption with key zdd: Uadfj lxtk rttegs xpoftba hajs hxt oftshd
Possible decryption with key zdh: Uazfj lxpk nttags xpkftxa dajo htt kftohd
Possible decryption with key zdq: Uaqfj lxgk ettrgs xpbftoa uajf hkt bftfhd
Possible decryption with key zds: Uaofj lxek cttpgs xpzftma sajd hit zftdhd
Possible decryption with key zdt: Uanfj lxdk bttogs xpyftla rajc hht yftchd
Possible decryption with key zed: Uzdfi lwtk rtsegr xoofsba hais gxt ofsshc
Possible decryption with key zei: Uzyfi lwok mtszgr xojfswa cain gst jfsnhc
Possible decryption with key zem: Uzufi lwkk itsvgr xoffssa yaij got ffsjhc
Possible decryption with key zes: Uzofi lwek ctspgr xozfsma said git zfsdhc
Possible decryption with key zfd: Uydfh lvtk rtregq xnofrba hahs fxt ofrshb
Possible decryption with key zfs: Uyofh lvek ctrpgq xnzfrma sahd fit zfrdhb
Possible decryption with key zgd: Uxdfg lutk rtqegp xmofqba hags ext ofqsha
Possible decryption with key zgs: Uxofg luek ctqpgp xmzfqma sagd eit zfqdha
Possible decryption with key zhd: Uwdff lttk rtpego xlofpba hafs dxt ofpshz
Possible decryption with key zhi: Uwyff ltok mtpzgo xljfpwa cafn dst jfpnhz
Possible decryption with key zhs: Uwoff ltek ctppgo xlzfpma safd dit zfpdhz
Possible decryption with key zia: Uvgfe lswk utohgn xkrfoea kaev cat rfovhy
Possible decryption with key zib: Uvffe lsvk ttoggn xkqfoda jaeu czt qfouhy
Possible decryption with key zic: Uvefe lsuk stofgn xkpfoca iaet cyt pfothy
Possible decryption with key zid: Uvdfe lstk rtoegn xkofoba haes cxt ofoshy
Possible decryption with key zie: Uvcfe lssk qtodgn xknfoaa gaer cwt nforhy
Possible decryption with key zif: Uvbfe lsrk ptocgn xkmfoza faeq cvt mfoqhy
Possible decryption with key zig: Uvafe lsqk otobgn xklfoya eaep cut lfophy
Possible decryption with key zih: Uvzfe lspk ntoagn xkkfoxa daeo ctt kfoohy
Possible decryption with key zii: Uvyfe lsok mtozgn xkjfowa caen cst jfonhy
Possible decryption with key zij: Uvxfe lsnk ltoygn xkifova baem crt ifomhy
Possible decryption with key zik: Uvwfe lsmk ktoxgn xkhfoua aael cqt hfolhy
Possible decryption with key zil: Uvvfe lslk jtowgn xkgfota zaek cpt gfokhy
Possible decryption with key zim: Uvufe lskk itovgn xkffosa yaej cot ffojhy
Possible decryption with key zin: Uvtfe lsjk htougn xkefora xaei cnt efoihy
Possible decryption with key zio: Uvsfe lsik gtotgn xkdfoqa waeh cmt dfohhy
Possible decryption with key zip: Uvrfe lshk ftosgn xkcfopa vaeg clt cfoghy
Possible decryption with key ziq: Uvqfe lsgk etorgn xkbfooa uaef ckt bfofhy
Possible decryption with key zir: Uvpfe lsfk dtoqgn xkafona taee cjt afoehy
Possible decryption with key zis: Uvofe lsek ctopgn xkzfoma saed cit zfodhy
Possible decryption with key zit: Uvnfe lsdk btoogn xkyfola raec cht yfochy
Possible decryption with key ziu: Uvmfe lsck atongn xkxfoka qaeb cgt xfobhy
Possible decryption with key ziv: Uvlfe lsbk ztomgn xkwfoja paea cft wfoahy
Possible decryption with key ziw: Uvkfe lsak ytolgn xkvfoia oaez cet vfozhy
Possible decryption with key zix: Uvjfe lszk xtokgn xkufoha naey cdt ufoyhy
Possible decryption with key ziy: Uvife lsyk wtojgn xktfoga maex cct tfoxhy
Possible decryption with key ziz: Uvhfe lsxk vtoign xksfofa laew cbt sfowhy
Possible decryption with key zjd: Uudfd lrtk rtnegm xjofnba hads bxt ofnshx
Possible decryption with key zjs: Uuofd lrek ctnpgm xjzfnma sadd bit zfndhx
Possible decryption with key zkd: Utdfc lqtk rtmegl xiofmba hacs axt ofmshw
Possible decryption with key zke: Utcfc lqsk qtmdgl xinfmaa gacr awt nfmrhw
Possible decryption with key zks: Utofc lqek ctmpgl xizfmma sacd ait zfmdhw
Possible decryption with key zkz: Uthfc lqxk vtmigl xisfmfa lacw abt sfmwhw
Possible decryption with key zld: Usdfb lptk rtlegk xhoflba habs zxt oflshv
Possible decryption with key zls: Usofb lpek ctlpgk xhzflma sabd zit zfldhv
Possible decryption with key zmd: Urdfa lotk rtkegj xgofkba haas yxt ofkshu
Possible decryption with key zmr: Urpfa lofk dtkqgj xgafkna taae yjt afkehu
Possible decryption with key zms: Urofa loek ctkpgj xgzfkma saad yit zfkdhu
Possible decryption with key znd: Uqdfz lntk rtjegi xfofjba hazs xxt ofjsht
Possible decryption with key zns: Uqofz lnek ctjpgi xfzfjma sazd xit zfjdht
Possible decryption with key zod: Updfy lmtk rtiegh xeofiba hays wxt ofishs
Possible decryption with key zoi: Upyfy lmok mtizgh xejfiwa cayn wst jfinhs
Possible decryption with key zom: Upufy lmkk itivgh xeffisa yayj wot ffijhs
Possible decryption with key zop: Uprfy lmhk ftisgh xecfipa vayg wlt cfighs
Possible decryption with key zor: Uppfy lmfk dtiqgh xeafina taye wjt afiehs
Possible decryption with key zos: Upofy lmek ctipgh xezfima sayd wit zfidhs
Possible decryption with key zou: Upmfy lmck atingh xexfika qayb wgt xfibhs
Possible decryption with key zpb: Uoffx llvk tthggg xdqfhda jaxu vzt qfhuhr
Possible decryption with key zpd: Uodfx lltk rthegg xdofhba haxs vxt ofhshr
Possible decryption with key zps: Uoofx llek cthpgg xdzfhma saxd vit zfhdhr
Possible decryption with key zqd: Undfw lktk rtgegf xcofgba haws uxt ofgshq
Possible decryption with key zqs: Unofw lkek ctgpgf xczfgma sawd uit zfgdhq
Possible decryption with key zrd: Umdfv ljtk rtfege xboffba havs txt offshp
Possible decryption with key zrm: Umufv ljkk itfvge xbfffsa yavj tot fffjhp
Possible decryption with key zrs: Umofv ljek ctfpge xbzffma savd tit zffdhp
Possible decryption with key zsd: Uldfu litk rteegd xaofeba haus sxt ofesho
Possible decryption with key zse: Ulcfu lisk qtedgd xanfeaa gaur swt nferho
Possible decryption with key zsj: Ulxfu link lteygd xaifeva baum srt ifemho
Possible decryption with key zss: Ulofu liek ctepgd xazfema saud sit zfedho
Possible decryption with key ztd: Ukdft lhtk rtdegc xzofdba hats rxt ofdshn
Possible decryption with key zth: Ukzft lhpk ntdagc xzkfdxa dato rtt kfdohn
Possible decryption with key zts: Ukoft lhek ctdpgc xzzfdma satd rit zfddhn
Possible decryption with key zud: Ujdfs lgtk rtcegb xyofcba hass qxt ofcshm
Possible decryption with key zus: Ujofs lgek ctcpgb xyzfcma sasd qit zfcdhm
Possible decryption with key zvd: Uidfr lftk rtbega xxofbba hars pxt ofbshl
Possible decryption with key zvo: Uisfr lfik gtbtga xxdfbqa warh pmt dfbhhl
Possible decryption with key zvs: Uiofr lfek ctbpga xxzfbma sard pit zfbdhl
Possible decryption with key zvt: Uinfr lfdk btboga xxyfbla rarc pht yfbchl
Possible decryption with key zwd: Uhdfq letk rtaegz xwofaba haqs oxt ofashk
Possible decryption with key zws: Uhofq leek ctapgz xwzfama saqd oit zfadhk
Possible decryption with key zwv: Uhlfq lebk ztamgz xwwfaja paqa oft wfaahk
Possible decryption with key zxd: Ugdfp ldtk rtzegy xvofzba haps nxt ofzshj
Possible decryption with key zxs: Ugofp ldek ctzpgy xvzfzma sapd nit zfzdhj
Possible decryption with key zyd: Ufdfo lctk rtyegx xuofyba haos mxt ofyshi
Possible decryption with key zyq: Ufqfo lcgk etyrgx xubfyoa uaof mkt bfyfhi
Possible decryption with key zys: Ufofo lcek ctypgx xuzfyma saod mit zfydhi
Possible decryption with key zzd: Uedfn lbtk rtxegw xtofxba hans lxt ofxshh
Possible decryption with key zzs: Ueofn lbek ctxpgw xtzfxma sand lit zfxdhh
